"GEOID10","TOTAL_POPULATION","HISP_LAT_TOTAL","HISP_LAT_NONHISPANIC_LATINO","HISP_LAT_HISPANIC_LATINO","TOTAL_POP_WHITE","MEDIAN_AGE"
36005000100,11091,11091,7312,3779,1724,30.8
36005000200,4334,4334,1341,2993,1332,32.8
36005000400,5503,5503,1748,3755,1497,34.6
36005001600,5643,5643,2161,3482,1556,30.6
36005001900,1917,1917,731,1186,591,30
36005002000,8731,8731,3370,5361,1985,31.6
36005002300,4933,4933,1710,3223,1054,26.5
36005002400,4,4,0,4,2,35
36005002500,5491,5491,1142,4349,1398,29.4
36005002701,3113,3113,1063,2050,736,25.6
36005002702,4475,4475,1090,3385,1076,24.2
36005002800,5586,5586,4347,1239,422,41.5
36005003100,1597,1597,579,1018,307,27.9
36005003300,3413,3413,948,2465,692,24.2
36005003500,3761,3761,974,2787,977,28.5
36005003700,245,245,86,159,60,35.5
36005003800,1264,1264,503,761,317,32
36005003900,6475,6475,1206,5269,1669,31.7
36005004001,1420,1420,694,726,472,41.7
36005004100,6127,6127,1678,4449,1342,25.7
36005004200,7143,7143,3195,3948,1487,33.7
36005004300,5056,5056,1222,3834,1410,28.8
36005004400,4797,4797,1884,2913,1080,30.7
36005004600,1555,1555,643,912,352,31.5
36005004800,3883,3883,894,2989,1094,31.4
36005005001,4767,4767,1461,3306,1248,29.3
36005005002,5823,5823,1206,4617,1512,32.5
36005005100,5810,5810,2115,3695,1184,26.5
36005005200,2031,2031,683,1348,425,30.9
36005005300,4669,4669,2642,2027,465,26.4
36005005400,5853,5853,2043,3810,1248,31.5
36005005600,2711,2711,881,1830,630,31.8
36005005902,2582,2582,951,1631,521,44.5
36005006000,1129,1129,191,938,330,30.4
36005006100,3713,3713,3148,565,195,51.9
36005006200,6585,6585,2380,4205,1310,30.8
36005006300,5280,5280,1799,3481,1110,38.4
36005006400,3967,3967,1802,2165,956,34.7
36005006500,5337,5337,1899,3438,1174,30.5
36005006700,6984,6984,1861,5123,1612,28.4
36005006800,2897,2897,1230,1667,675,35.5
36005006900,7564,7564,2817,4747,1483,26.6
36005007000,4584,4584,1793,2791,1079,34.3
36005007100,1907,1907,664,1243,379,29.8
36005007200,5432,5432,2614,2818,1377,34.8
36005007300,3893,3893,964,2929,887,29.9
36005007400,3710,3710,1592,2118,827,39.7
36005007500,4869,4869,1563,3306,1224,29.7
36005007600,5190,5190,1772,3418,1430,31.1
36005007700,1927,1927,507,1420,463,29.5
36005007800,6418,6418,2134,4284,1979,31.5
36005007900,6733,6733,1845,4888,1584,26.7
36005008300,6155,6155,1066,5089,1639,27.5
36005008400,2374,2374,926,1448,539,35.1
36005008500,5457,5457,1284,4173,1292,29.1
36005008600,4176,4176,1534,2642,1094,24.3
36005008700,5466,5466,1192,4274,1584,28.8
36005008900,3177,3177,536,2641,978,27.4
36005009000,3667,3667,1300,2367,949,28
36005009200,5017,5017,1973,3044,1478,32.5
36005009300,6356,6356,1921,4435,1616,27.4
36005009600,2594,2594,1053,1541,765,37
36005009800,5038,5038,1901,3137,1463,37
36005011000,151,151,32,119,70,21.5
36005011502,4340,4340,1203,3137,944,25.2
36005011700,1585,1585,473,1112,272,31.7
36005011800,5089,5089,4211,878,4418,21.9
36005011900,5698,5698,1579,4119,1383,27.5
36005012101,3090,3090,1010,2080,814,29.4
36005012102,1631,1631,331,1300,420,22.2
36005012300,4152,4152,1228,2924,966,26.9
36005012500,3905,3905,1345,2560,799,27.5
36005012701,2253,2253,611,1642,644,34
36005012901,4015,4015,1309,2706,796,28.3
36005013000,1032,1032,534,498,759,33.5
36005013100,5103,5103,1814,3289,975,29.5
36005013200,5890,5890,2879,3011,3624,34.6
36005013300,6384,6384,2692,3692,1222,30
36005013500,3583,3583,1611,1972,530,31.9
36005013800,3042,3042,2216,826,2359,36.7
36005014100,3437,3437,1330,2107,787,27.3
36005014300,1003,1003,565,438,137,44.8
36005014400,5880,5880,2294,3586,1731,30
36005014500,5816,5816,2921,2895,736,29.1
36005014701,6461,6461,3153,3308,842,25.4
36005014702,5110,5110,2284,2826,597,26.2
36005014900,4591,4591,2000,2591,880,34.8
36005015100,5409,5409,2656,2753,753,29.6
36005015200,2341,2341,1046,1295,1402,26.8
36005015300,4031,4031,2049,1982,588,28.3
36005015500,3005,3005,674,2331,692,31.1
36005015700,3580,3580,1334,2246,677,27.3
36005015800,1206,1206,636,570,783,31.9
36005015900,2164,2164,245,1919,674,27.2
36005016000,3767,3767,2799,968,3028,37.3
36005016100,4380,4380,1564,2816,940,34
36005016200,1769,1769,1118,651,1308,33.5
36005016300,0,0,0,0,0,0
36005016400,1141,1141,704,437,806,27.5
36005016500,1077,1077,497,580,152,31
36005016600,2166,2166,1082,1084,1276,35.3
36005016700,2047,2047,1043,1004,259,28.5
36005016900,1663,1663,913,750,215,30.2
36005017100,0,0,0,0,0,0
36005017300,5987,5987,2356,3631,989,30.1
36005017500,6911,6911,2999,3912,991,30.2
36005017701,4294,4294,1945,2349,750,34.1
36005017702,4805,4805,2198,2607,640,31
36005017901,4677,4677,1319,3358,787,33.2
36005017902,3587,3587,1429,2158,556,28.9
36005018101,3300,3300,1563,1737,385,32.2
36005018102,5555,5555,2604,2951,787,35
36005018301,4525,4525,1963,2562,888,47.8
36005018302,3647,3647,1584,2063,623,34.6
36005018400,3855,3855,2598,1257,2926,29.8
36005018500,7466,7466,3186,4280,1197,29.4
36005018900,7752,7752,2688,5064,1334,32.4
36005019300,5461,5461,1924,3537,957,33.1
36005019400,1903,1903,819,1084,935,27.4
36005019500,7756,7756,2710,5046,1373,33.3
36005019700,7501,7501,2216,5285,1674,32.1
36005019900,8154,8154,2627,5527,1493,32
36005020000,4878,4878,2250,2628,1200,27.9
36005020100,4013,4013,1540,2473,686,32.2
36005020200,2155,2155,854,1301,747,30.9
36005020400,2976,2976,1076,1900,853,30.3
36005020501,6996,6996,2808,4188,1080,33.9
36005020502,1764,1764,609,1155,279,37.9
36005020601,3050,3050,1324,1726,911,39.2
36005020900,4361,4361,1566,2795,721,34.9
36005021001,8521,8521,5291,3230,1534,38.4
36005021002,6839,6839,4542,2297,1029,39.8
36005021100,5565,5565,2133,3432,971,29.3
36005021200,5267,5267,3627,1640,842,41.5
36005021301,1201,1201,250,951,378,30.4
36005021302,5415,5415,2207,3208,865,30.2
36005021501,3506,3506,1023,2483,686,25.9
36005021502,6051,6051,1940,4111,1135,29.8
36005021601,4206,4206,1489,2717,1183,30.4
36005021602,5769,5769,3662,2107,887,38.6
36005021700,5334,5334,2546,2788,811,37
36005021800,6499,6499,2315,4184,1616,32.1
36005021900,1367,1367,343,1024,328,30.3
36005022000,1487,1487,416,1071,368,25.4
36005022101,3849,3849,984,2865,996,30.8
36005022102,5488,5488,892,4596,1295,33.1
36005022200,3425,3425,1335,2090,899,30.3
36005022300,5047,5047,1084,3963,1027,33.6
36005022401,2708,2708,1118,1590,1043,34
36005022403,3188,3188,1295,1893,1476,34.8
36005022404,4509,4509,2330,2179,1891,32.8
36005022500,7698,7698,2526,5172,1495,29.8
36005022701,5196,5196,1859,3337,1017,30.7
36005022702,1699,1699,636,1063,269,34.1
36005022703,1556,1556,442,1114,406,36
36005022800,6218,6218,3145,3073,2504,31.5
36005022901,5370,5370,1941,3429,924,32
36005022902,3273,3273,991,2282,596,28.6
36005023000,2950,2950,1269,1681,1104,30.2
36005023100,1537,1537,577,960,234,35.2
36005023200,2661,2661,1206,1455,1183,28.9
36005023301,4377,4377,1627,2750,641,35.2
36005023302,3415,3415,625,2790,649,32.3
36005023501,3341,3341,743,2598,695,32.3
36005023502,4386,4386,1151,3235,1195,36.9
36005023600,1907,1907,753,1154,778,30.2
36005023702,1241,1241,283,958,306,31.1
36005023703,5253,5253,1303,3950,1333,32.6
36005023704,3758,3758,968,2790,697,32.5
36005023800,2615,2615,1011,1604,1088,29.2
36005023900,8348,8348,2037,6311,1958,30.2
36005024000,3882,3882,1425,2457,977,30.3
36005024100,6182,6182,1851,4331,1130,29.6
36005024300,5685,5685,1761,3924,1017,31.1
36005024400,2120,2120,1349,771,1390,33.3
36005024501,4864,4864,1151,3713,893,31.4
36005024502,3640,3640,1005,2635,586,32.5
36005024600,2058,2058,1412,646,1226,31.5
36005024700,1764,1764,942,822,224,38.8
36005024800,3363,3363,2482,881,2114,61
36005024900,0,0,0,0,0,0
36005025000,2383,2383,1888,495,1783,29.8
36005025100,6802,6802,2226,4576,1264,32
36005025200,2530,2530,1792,738,1682,29.3
36005025300,6332,6332,1640,4692,1455,30.9
36005025400,1959,1959,1589,370,1524,31.8
36005025500,6529,6529,1491,5038,1389,32.6
36005025600,1663,1663,943,720,823,35.3
36005025700,1912,1912,463,1449,313,36.3
36005026100,1932,1932,1330,602,367,48.7
36005026300,6984,6984,2178,4806,1955,44
36005026400,4935,4935,3085,1850,3419,30.1
36005026500,6942,6942,1754,5188,1761,31.3
36005026601,2911,2911,1794,1117,2101,33.1
36005026602,5301,5301,3019,2282,3566,38.3
36005026701,4037,4037,1251,2786,913,30.3
36005026702,7040,7040,1658,5382,1995,32.2
36005026900,3777,3777,1008,2769,966,36.2
36005027300,7942,7942,2074,5868,2290,37.2
36005027401,4785,4785,3949,836,4280,28
36005027402,3386,3386,2871,515,3080,41.5
36005027600,473,473,348,125,96,45.5
36005027700,5065,5065,1320,3745,1633,34.7
36005027900,6966,6966,3179,3787,3062,38.3
36005028100,3794,3794,2362,1432,2145,43.4
36005028300,3149,3149,1202,1947,792,34.7
36005028400,894,894,646,248,436,48.4
36005028500,3307,3307,2232,1075,2073,39.5
36005028600,1191,1191,898,293,790,28
36005028700,3178,3178,1390,1788,1324,38
36005028800,3097,3097,2530,567,2384,33.4
36005028900,4502,4502,1655,2847,2055,37.2
36005029301,1875,1875,1634,241,1549,66.8
36005029302,5052,5052,4347,705,3907,48.9
36005029500,4240,4240,3305,935,3105,37.9
36005029600,2549,2549,2012,537,1193,35.9
36005029700,3554,3554,3076,478,2797,47
36005030000,5838,5838,3379,2459,3859,33.7
36005030100,1304,1304,1116,188,1055,59.9
36005030200,8887,8887,6457,2430,1648,44.6
36005030701,5378,5378,4723,655,4646,44.4
36005030900,3891,3891,3581,310,3372,80.6
36005031000,4415,4415,3194,1221,2404,57.7
36005031200,1524,1524,1076,448,911,39.7
36005031400,1966,1966,1378,588,1177,46
36005031600,1863,1863,1344,519,1026,31.7
36005031800,1810,1810,1210,600,984,38.3
36005031900,751,751,607,144,516,20.4
36005032300,4904,4904,3957,947,3748,49.3
36005032400,2957,2957,1458,1499,1164,32.7
36005032600,3154,3154,2258,896,1756,43.3
36005032800,3979,3979,2177,1802,1576,29.7
36005033000,5696,5696,3214,2482,2841,35
36005033201,4115,4115,1825,2290,1920,36.7
36005033202,4167,4167,1998,2169,1482,41.3
36005033400,1351,1351,595,756,449,30.1
36005033500,2178,2178,1917,261,1841,47.6
36005033600,6188,6188,3022,3166,1326,33.1
36005033700,2357,2357,1983,374,1808,41.5
36005033800,3818,3818,2210,1608,856,31.7
36005034000,4618,4618,2363,2255,1152,33
36005034200,1675,1675,1111,564,290,33.7
36005034300,1649,1649,1091,558,942,54.6
36005034400,1736,1736,1130,606,360,38.9
36005034500,3566,3566,2725,841,2205,46.1
36005034800,6129,6129,3814,2315,1137,34.6
36005035000,1925,1925,1393,532,239,33.7
36005035100,3186,3186,2381,805,2218,36.8
36005035600,2027,2027,1638,389,211,35.2
36005035800,7166,7166,6125,1041,474,38.7
36005035900,2061,2061,569,1492,557,29.1
36005036000,2706,2706,1812,894,803,39.8
36005036100,6019,6019,1703,4316,1702,28.7
36005036300,7509,7509,1876,5633,2113,26.3
36005036400,2557,2557,2282,275,73,38.2
36005036501,3965,3965,1851,2114,784,28.4
36005036502,2423,2423,749,1674,499,27.5
36005036700,2599,2599,866,1733,575,25
36005036800,2011,2011,1556,455,192,32.3
36005036901,2005,2005,554,1451,513,29.2
36005036902,2119,2119,871,1248,445,29.3
36005037000,2303,2303,1810,493,263,39.4
36005037100,4241,4241,1564,2677,1061,36.1
36005037200,2222,2222,1467,755,315,35
36005037300,5318,5318,1941,3377,1190,28.8
36005037400,3441,3441,1936,1505,556,34.7
36005037504,3677,3677,1243,2434,822,30.9
36005037600,2148,2148,1333,815,389,36
36005037800,3048,3048,1990,1058,487,32.3
36005037900,5093,5093,2567,2526,743,24.9
36005038000,4585,4585,3555,1030,392,38.1
36005038100,6382,6382,1818,4564,1417,35.2
36005038200,2596,2596,2117,479,153,33
36005038301,4797,4797,1481,3316,981,30.2
36005038302,6106,6106,2635,3471,900,27.5
36005038500,4758,4758,1589,3169,1071,25.2
36005038600,7409,7409,6227,1182,412,33.1
36005038700,3216,3216,1262,1954,1069,30.9
36005038800,2606,2606,2239,367,122,36.4
36005038900,5325,5325,2250,3075,2404,25.8
36005039000,2975,2975,2277,698,196,31.3
36005039100,6992,6992,2044,4948,2515,27.1
36005039200,1781,1781,1290,491,194,31.7
36005039300,8143,8143,3213,4930,2046,27.8
36005039400,4573,4573,3076,1497,578,35.3
36005039500,4146,4146,1484,2662,769,28
36005039600,3756,3756,3020,736,205,33.9
36005039700,3702,3702,2680,1022,2497,22.4
36005039800,3090,3090,2781,309,82,34.9
36005039901,5228,5228,1836,3392,1151,30.1
36005039902,5279,5279,1583,3696,1027,29.2
36005040100,4593,4593,1177,3416,1201,33.8
36005040302,4386,4386,914,3472,1145,29.2
36005040303,4478,4478,980,3498,1116,33.3
36005040304,3794,3794,1021,2773,945,32.4
36005040400,3016,3016,2564,452,195,35
36005040501,4397,4397,1295,3102,955,29.3
36005040502,6863,6863,2358,4505,1437,32.1
36005040600,3490,3490,2897,593,146,32.9
36005040701,3347,3347,841,2506,933,31.4
36005040702,6652,6652,2143,4509,2051,31
36005040800,4263,4263,2620,1643,559,31.7
36005040900,3637,3637,3123,514,851,39.3
36005041100,2931,2931,1111,1820,883,32.2
36005041300,7384,7384,2652,4732,2690,33.1
36005041400,5027,5027,3982,1045,564,32.8
36005041500,5461,5461,2104,3357,1840,34.1
36005041800,3598,3598,2596,1002,439,32.7
36005041900,6734,6734,2823,3911,2147,32.9
36005042000,3850,3850,2511,1339,629,33.1
36005042100,5922,5922,2450,3472,1638,32.5
36005042200,3086,3086,2526,560,317,36.7
36005042300,4100,4100,1710,2390,1425,30.1
36005042400,2481,2481,2068,413,203,40.6
36005042500,6793,6793,2556,4237,2236,29.4
36005042600,6387,6387,5719,668,389,37.4
36005042800,2173,2173,1938,235,128,38.8
36005042901,3420,3420,1333,2087,1112,31
36005042902,3845,3845,1598,2247,1136,31.1
36005043000,2898,2898,2420,478,252,38.1
36005043100,9680,9680,4239,5441,2172,36.1
36005043400,3592,3592,2881,711,437,34.1
36005043500,39,39,13,26,9,24
36005043600,2032,2032,1714,318,213,36.6
36005044200,3555,3555,2788,767,314,34.4
36005044400,3878,3878,3266,612,306,38.5
36005044800,2026,2026,1784,242,103,39.7
36005044901,1818,1818,1648,170,1655,33.3
36005044902,1949,1949,1716,233,1771,19.5
36005045101,1656,1656,1484,172,1445,31.9
36005045102,1894,1894,1686,208,1660,37.5
36005045600,2896,2896,2338,558,780,37.2
36005045800,6123,6123,2795,3328,1189,26.4
36005046000,2741,2741,2115,626,343,38.5
36005046201,26588,26588,19208,7380,6008,46
36005046202,8277,8277,5953,2324,1132,36.5
36005048400,3598,3598,3018,580,288,36.6
36005050400,39,39,15,24,15,44.5
36005051600,4362,4362,3621,741,3727,37.6
36047000100,4338,4338,3991,347,3396,52.1
36047000200,1470,1470,193,1277,530,22
36047000301,4259,4259,4013,246,3658,43
36047000501,4247,4247,3935,312,3266,21.1
36047000502,2512,2512,2350,162,2086,43.7
36047000700,3359,3359,3076,283,2885,37.5
36047000900,4172,4172,3847,325,3018,35.3
36047001100,84,84,56,28,36,40.5
36047001300,2275,2275,1964,311,1531,43.4
36047001500,3521,3521,2710,811,1350,35.6
36047001800,2105,2105,906,1199,1204,34.2
36047002000,1672,1672,199,1473,629,38.7
36047002100,3604,3604,3289,315,2820,40.5
36047002200,4613,4613,1611,3002,2034,41.3
36047002300,4247,4247,2999,1248,448,31.4
36047002901,3218,3218,2251,967,336,29.5
36047003000,1730,1730,1435,295,1246,33
36047003100,2472,2472,2199,273,607,44.6
36047003300,2327,2327,1978,349,1283,38.2
36047003400,3047,3047,2627,420,2272,43.5
36047003500,1554,1554,1391,163,637,42.2
36047003600,3804,3804,3263,541,2824,30.8
36047003700,390,390,336,54,195,27.1
36047003800,1498,1498,1381,117,1247,32.5
36047003900,2229,2229,1823,406,1355,47.3
36047004100,3598,3598,3150,448,2616,50.9
36047004300,3008,3008,2472,536,2199,36.6
36047004400,2359,2359,2254,105,2161,36.5
36047004500,3325,3325,3107,218,2931,44.3
36047004600,1199,1199,1099,100,1063,15
36047004700,1445,1445,1087,358,898,42.8
36047004900,2516,2516,2198,318,1875,62.1
36047005000,2276,2276,2078,198,2027,36.5
36047005100,2171,2171,1710,461,1646,39.5
36047005201,1829,1829,1718,111,1595,67.5
36047005202,2481,2481,2302,179,2242,39.5
36047005300,1888,1888,1297,591,1287,36.3
36047005400,3139,3139,2759,380,2565,35.5
36047005601,2505,2505,2259,246,2225,44.5
36047005602,1586,1586,1464,122,1369,25.6
36047005800,3152,3152,2729,423,2549,34.7
36047005900,1384,1384,935,449,830,26.3
36047006000,2826,2826,2204,622,1950,29.5
36047006200,2853,2853,2409,444,2123,35.5
36047006300,1892,1892,1704,188,1618,41.3
36047006400,3478,3478,2918,560,2658,34.6
36047006500,5191,5191,4690,501,4575,36
36047006600,3663,3663,2961,702,2772,34.7
36047006700,3301,3301,3042,259,2931,36.8
36047006800,4870,4870,3566,1304,2929,34.8
36047006900,3537,3537,2925,612,2820,41.8
36047007000,2344,2344,1906,438,1573,44.8
36047007100,4495,4495,2733,1762,1627,31.1
36047007200,1946,1946,808,1138,730,31.2
36047007400,5451,5451,1802,3649,1708,33.8
36047007500,4383,4383,3875,508,3823,35.5
36047007600,4412,4412,1262,3150,1600,31.3
36047007700,3901,3901,3502,399,3253,45.1
36047007800,5068,5068,1041,4027,1684,31.7
36047008000,4169,4169,890,3279,1670,40
36047008200,4141,4141,1121,3020,1628,30.4
36047008400,3299,3299,868,2431,1473,33.9
36047008500,6956,6956,3625,3331,1297,27.6
36047008600,0,0,0,0,0,0
36047008800,3207,3207,1169,2038,1442,32
36047009000,2994,2994,1725,1269,847,29.5
36047009200,5388,5388,3146,2242,1450,38
36047009400,5805,5805,4709,1096,1500,35.6
36047009600,6126,6126,2461,3665,2008,34.2
36047009800,7024,7024,3389,3635,1635,35
36047010000,6737,6737,4294,2443,1613,34.6
36047010100,4093,4093,1489,2604,1980,33.5
36047010200,5622,5622,4214,1408,1201,28.5
36047010400,5908,5908,5536,372,633,30.5
36047010600,5851,5851,5152,699,573,31
36047010800,5280,5280,4530,750,931,31.5
36047011000,2441,2441,1284,1157,868,28.6
36047011200,6436,6436,4257,2179,3444,35.9
36047011400,3976,3976,3366,610,2580,41.8
36047011600,4816,4816,4393,423,847,40.8
36047011700,2364,2364,1385,979,1416,39.3
36047011800,2253,2253,2013,240,323,29.8
36047011900,1530,1530,1134,396,1081,36.1
36047012000,1268,1268,1133,135,160,31.5
36047012100,1619,1619,1077,542,1043,39
36047012200,5339,5339,2915,2424,1719,38
36047012600,2652,2652,2116,536,1347,36
36047012700,3507,3507,2057,1450,1276,34.4
36047012801,2117,2117,1942,175,782,32.5
36047012901,2159,2159,1622,537,1379,40
36047012902,1964,1964,1647,317,1410,44.5
36047013000,4792,4792,3659,1133,3098,34.2
36047013100,3828,3828,3064,764,2575,42.1
36047013200,2239,2239,1917,322,1194,28.5
36047013300,3730,3730,3171,559,2826,39.5
36047013400,3907,3907,3300,607,2858,34.3
36047013500,3596,3596,3104,492,2713,40.4
36047013600,3927,3927,3260,667,2972,36
36047013700,3057,3057,2477,580,2245,47.5
36047013800,3168,3168,2713,455,2444,31.5
36047013900,3481,3481,2836,645,2484,38.2
36047014000,1826,1826,1640,186,1528,32.5
36047014100,3017,3017,2305,712,2155,34.8
36047014200,3223,3223,2716,507,2384,31.3
36047014300,3487,3487,2093,1394,2244,33.6
36047014500,4179,4179,2357,1822,2620,30.2
36047014700,2084,2084,1253,831,1434,38.3
36047014800,1209,1209,1133,76,1075,45.2
36047014900,4976,4976,4018,958,3837,40.9
36047015000,1574,1574,1485,89,1359,7
36047015100,3578,3578,3195,383,2924,45.3
36047015200,2309,2309,2048,261,1741,41.5
36047015300,3041,3041,2742,299,2342,42.9
36047015400,0,0,0,0,0,0
36047015500,3272,3272,2993,279,2744,50.3
36047015700,4135,4135,3830,305,3399,45.7
36047015900,5036,5036,4693,343,4052,48
36047016000,4217,4217,3378,839,2759,33
36047016100,3075,3075,2658,417,2062,42.7
36047016200,2082,2082,1782,300,1551,37.3
36047016300,2991,2991,2644,347,1693,44.8
36047016400,764,764,520,244,347,26.8
36047016500,5141,5141,4810,331,4432,45.8
36047016600,2059,2059,1986,73,1940,39
36047016700,4638,4638,4190,448,3945,39.3
36047016800,1510,1510,1425,85,1209,22.5
36047016900,4497,4497,3538,959,3231,46.3
36047017000,3254,3254,2930,324,2012,31.5
36047017100,3749,3749,3443,306,3198,41.6
36047017200,2931,2931,2629,302,1734,29
36047017400,1793,1793,1648,145,1213,41.5
36047017500,5,5,3,2,3,0
36047017600,2295,2295,1930,365,1389,30.5
36047017700,0,0,0,0,0,0
36047017800,2898,2898,2397,501,1428,34.7
36047017900,3624,3624,3140,484,894,44.3
36047018000,3193,3193,2534,659,1752,36.2
36047018100,3936,3936,3528,408,2234,42.8
36047018200,3163,3163,2855,308,1329,33.3
36047018300,2500,2500,2209,291,1457,41.3
36047018400,2002,2002,1925,77,1233,28.8
36047018501,3827,3827,2758,1069,515,30.8
36047018600,2124,2124,1985,139,1121,33.3
36047018700,1411,1411,1068,343,631,33.8
36047018800,2640,2640,2342,298,1614,38.5
36047019000,4782,4782,3655,1127,2058,32.7
36047019100,2332,2332,1715,617,1086,35.8
36047019200,2772,2772,2309,463,1587,34.5
36047019300,5628,5628,4931,697,2185,52.6
36047019400,3305,3305,2702,603,1151,31.5
36047019500,3366,3366,2926,440,1498,44.7
36047019600,4353,4353,3521,832,2254,28.5
36047019700,3313,3313,3017,296,1465,46.3
36047019800,1702,1702,1442,260,1251,30
36047019900,2929,2929,2602,327,1227,43.5
36047020000,2265,2265,1882,383,1494,33.8
36047020100,3421,3421,3150,271,1560,41.5
36047020200,1874,1874,1749,125,1454,28.5
36047020300,1697,1697,1386,311,711,40
36047020400,1708,1708,1591,117,1481,38.5
36047020500,2469,2469,2244,225,1261,38.9
36047020600,2220,2220,1957,263,1742,32.5
36047020700,4310,4310,3881,429,2398,45.1
36047020800,3048,3048,2697,351,1537,33.5
36047021000,3968,3968,3549,419,1806,30
36047021100,1210,1210,760,450,315,37.5
36047021200,4643,4643,4132,511,1398,32.5
36047021300,4205,4205,3784,421,554,37.4
36047021400,2152,2152,2023,129,1246,52
36047021500,5307,5307,4761,546,2108,40.6
36047021600,4015,4015,3851,164,3419,28.5
36047021700,3597,3597,3053,544,814,36.2
36047021800,3761,3761,3482,279,3387,27.5
36047021900,3595,3595,3286,309,777,37.6
36047022000,4939,4939,4617,322,4370,25
36047022100,3609,3609,3102,507,695,37.1
36047022200,4693,4693,4179,514,4195,28.5
36047022400,5486,5486,4578,908,4223,31.3
36047022600,2516,2516,1155,1361,1032,31.5
36047022700,3454,3454,3209,245,597,38.4
36047022800,3306,3306,2771,535,1879,39.8
36047022900,3395,3395,3088,307,822,36.5
36047023000,4515,4515,3631,884,3728,30.5
36047023100,3025,3025,2700,325,1080,40.3
36047023200,5699,5699,5343,356,5064,24.5
36047023300,5061,5061,3926,1135,1137,31.8
36047023400,5059,5059,4985,74,4976,31
36047023500,3928,3928,2892,1036,2456,31.5
36047023600,5600,5600,5547,53,5274,32
36047023800,4590,4590,4422,168,4441,46
36047024000,4693,4693,4501,192,4480,33
36047024100,2229,2229,1703,526,975,38.5
36047024200,2984,2984,2794,190,2683,38
36047024300,3786,3786,3236,550,726,37.8
36047024400,3238,3238,2909,329,2660,31
36047024500,3946,3946,3653,293,431,36.7
36047024600,3256,3256,2971,285,2185,30.5
36047024700,2316,2316,2142,174,230,35.6
36047024800,2698,2698,2389,309,1441,25.7
36047024900,3823,3823,3500,323,427,36.3
36047025000,1722,1722,1511,211,511,30
36047025100,3816,3816,3088,728,370,31
36047025200,4786,4786,4065,721,2457,33
36047025300,2754,2754,2233,521,503,37.2
36047025400,3500,3500,3131,369,1423,35
36047025500,5102,5102,2382,2720,915,31.3
36047025600,3058,3058,2866,192,1260,29.5
36047025700,2131,2131,1029,1102,659,28.9
36047025800,4597,4597,3840,757,2506,29.6
36047025901,2010,2010,1107,903,436,28.3
36047025902,3419,3419,1815,1604,531,26.2
36047026000,3649,3649,3279,370,1664,40.5
36047026100,4917,4917,3593,1324,699,31.7
36047026200,2374,2374,2082,292,1050,24.3
36047026300,1868,1868,1510,358,144,34.8
36047026400,4592,4592,3632,960,2311,27.2
36047026500,3838,3838,3278,560,270,34.2
36047026600,3733,3733,3296,437,1993,48.5
36047026700,3920,3920,3573,347,364,40.6
36047026800,4188,4188,3584,604,2583,37
36047026900,2770,2770,2541,229,241,38.3
36047027000,2449,2449,2318,131,1684,42.5
36047027100,2471,2471,2257,214,80,36.5
36047027200,3480,3480,2842,638,1936,34
36047027300,2813,2813,2646,167,160,37.3
36047027400,3028,3028,2777,251,1647,40.5
36047027500,4180,4180,3781,399,380,38
36047027600,3694,3694,2957,737,1885,24.7
36047027700,3945,3945,3590,355,164,31.5
36047027800,3220,3220,2720,500,1935,30.5
36047027900,3674,3674,3270,404,185,35
36047028000,1761,1761,1521,240,931,29.5
36047028100,4193,4193,2662,1531,562,28.8
36047028200,2943,2943,2693,250,1850,32.5
36047028300,4097,4097,2590,1507,600,30.8
36047028400,4003,4003,3289,714,2372,30.8
36047028501,428,428,179,249,135,30.8
36047028502,2802,2802,1437,1365,497,33.8
36047028600,4814,4814,4203,611,3098,32.4
36047028700,2991,2991,1792,1199,593,33.2
36047028800,3458,3458,2806,652,1766,39.5
36047028900,3538,3538,2430,1108,426,32.8
36047029000,3920,3920,3504,416,2873,31.5
36047029100,3101,3101,2637,464,215,36.3
36047029200,2539,2539,2127,412,1477,31.5
36047029300,3106,3106,2660,446,131,37.6
36047029400,2321,2321,2118,203,1524,51.1
36047029500,3425,3425,3105,320,248,37.6
36047029600,5546,5546,4990,556,3683,29.8
36047029700,3344,3344,3139,205,243,36.3
36047029800,3717,3717,3045,672,2028,34.5
36047029900,2579,2579,2082,497,128,28.9
36047030000,4120,4120,3701,419,1791,39.5
36047030100,2750,2750,2425,325,165,32.6
36047030200,4214,4214,3943,271,1921,40.5
36047030300,4458,4458,3791,667,166,28
36047030400,4281,4281,3835,446,2239,34.5
36047030500,5549,5549,4665,884,1806,38.2
36047030600,2005,2005,1675,330,1078,33.5
36047030700,4544,4544,3907,637,192,31.2
36047030800,1949,1949,1710,239,1323,35.5
36047030900,1754,1754,1473,281,69,29.5
36047031100,2833,2833,2561,272,161,33.3
36047031300,4648,4648,4242,406,326,39.4
36047031400,4544,4544,4083,461,3219,45
36047031500,5175,5175,4676,499,600,37.4
36047031701,3433,3433,3215,218,359,36.2
36047031702,3363,3363,3029,334,568,38.5
36047031900,3508,3508,3284,224,957,41.4
36047032100,5001,5001,4087,914,530,37.7
36047032300,3554,3554,3085,469,342,37.8
36047032500,6405,6405,5963,442,340,35.9
36047032600,6948,6948,4569,2379,1812,24.5
36047032700,2924,2924,2567,357,387,38.5
36047032800,3138,3138,2533,605,496,31.2
36047032900,5582,5582,4796,786,1372,41
36047033000,4587,4587,3354,1233,1355,27.9
36047033100,4520,4520,4298,222,2738,40.9
36047033300,4085,4085,3898,187,2663,42
36047033500,3139,3139,3030,109,1938,45
36047033600,4759,4759,4261,498,3971,42.8
36047033700,4105,4105,3850,255,1976,42
36047033900,4376,4376,4035,341,413,39.6
36047034000,2248,2248,1669,579,1076,39.1
36047034100,2607,2607,2383,224,230,40.8
36047034200,6502,6502,4930,1572,2497,27.7
36047034300,5281,5281,4246,1035,289,32.7
36047034500,2647,2647,2455,192,54,34.4
36047034700,3228,3228,2806,422,123,32.8
36047034800,2537,2537,1235,1302,1040,31.3
36047034900,5403,5403,4842,561,324,34.7
36047035000,3296,3296,3266,30,3213,50.5
36047035100,4597,4597,4027,570,859,34.8
36047035200,1246,1246,1045,201,871,55.4
36047035300,5161,5161,4489,672,841,34.4
36047035400,6271,6271,6122,149,6012,50
36047035500,5253,5253,4819,434,845,37.4
36047035601,2912,2912,2824,88,2725,49.9
36047035602,5271,5271,5139,132,5103,46.8
36047035700,2506,2506,2041,465,129,29.6
36047035900,5685,5685,4980,705,248,29.5
36047036001,3217,3217,3089,128,3096,43.5
36047036002,3930,3930,3735,195,3675,40.5
36047036100,2608,2608,2142,466,142,34.5
36047036200,4204,4204,2562,1642,2028,41
36047036300,4108,4108,3524,584,128,31.9
36047036400,2405,2405,1936,469,1445,38
36047036501,2624,2624,2323,301,69,36
36047036502,1255,1255,841,414,192,33.8
36047036600,4767,4767,3528,1239,2515,48
36047036700,1305,1305,803,502,201,31
36047036900,4923,4923,3642,1281,437,30.7
36047037000,4085,4085,3843,242,3017,40.5
36047037100,4120,4120,3592,528,162,30.5
36047037300,3784,3784,3136,648,252,33.7
36047037401,4301,4301,4092,209,3630,33.5
36047037402,4573,4573,4260,313,3701,40
36047037500,2910,2910,2351,559,241,32
36047037700,3660,3660,3282,378,187,35.3
36047037900,3706,3706,3201,505,152,32.6
36047038100,4763,4763,4135,628,229,33.6
36047038200,5943,5943,3973,1970,1078,26.3
36047038300,3931,3931,3539,392,165,35.7
36047038500,3422,3422,2898,524,151,35.3
36047038600,3477,3477,2917,560,2025,29.5
36047038700,4010,4010,3184,826,393,34
36047038800,3841,3841,3562,279,3266,27.2
36047038900,2773,2773,918,1855,1144,32.4
36047039000,2282,2282,2179,103,2077,31.5
36047039100,2303,2303,633,1670,929,29.7
36047039200,2756,2756,2561,195,2361,32.5
36047039300,3549,3549,1440,2109,1176,35.4
36047039400,2441,2441,2245,196,2230,44.3
36047039500,3380,3380,1261,2119,1079,40.4
36047039600,2126,2126,1967,159,1982,42.5
36047039700,3389,3389,2198,1191,575,35.3
36047039800,2644,2644,2010,634,1430,28.5
36047039900,3823,3823,1965,1858,702,32.8
36047040000,3069,3069,2459,610,1732,38
36047040100,3518,3518,1935,1583,566,31
36047040200,2740,2740,2349,391,1248,27.5
36047040300,3538,3538,2445,1093,413,32.9
36047040400,2551,2551,2243,308,1292,28
36047040500,1480,1480,860,620,245,31.5
36047040600,3184,3184,2849,335,1606,28.5
36047040700,14,14,6,8,7,48.5
36047040800,3566,3566,3004,562,1525,31
36047040900,3752,3752,1081,2671,957,29.2
36047041000,1773,1773,1608,165,1346,34.5
36047041100,3302,3302,1708,1594,433,36
36047041200,2929,2929,2539,390,1704,31.5
36047041300,3822,3822,1727,2095,679,32.8
36047041401,1351,1351,1223,128,1192,42
36047041402,1612,1612,1550,62,1500,38.5
36047041500,4064,4064,1803,2261,652,31.5
36047041600,2324,2324,2174,150,2123,28.5
36047041700,3609,3609,1062,2547,1102,30.4
36047041800,2359,2359,2129,230,2057,26.6
36047041900,3770,3770,967,2803,1066,31
36047042000,1896,1896,1711,185,1676,26.5
36047042100,3920,3920,1133,2787,1397,30.2
36047042200,3568,3568,2918,650,2869,29.3
36047042300,4217,4217,1041,3176,1767,31.7
36047042400,3666,3666,3142,524,2124,36.5
36047042500,3042,3042,812,2230,1324,26.1
36047042600,4135,4135,3508,627,2175,22.9
36047042700,5074,5074,1396,3678,2251,29
36047042800,3857,3857,3575,282,2731,47.2
36047042900,5630,5630,1172,4458,1892,29.3
36047043000,3333,3333,2974,359,2115,39.5
36047043100,5113,5113,1091,4022,1785,28.6
36047043200,4250,4250,3325,925,2134,32.3
36047043300,4064,4064,854,3210,1160,28.3
36047043400,3433,3433,2925,508,2171,40
36047043500,4463,4463,1181,3282,1228,33.3
36047043600,4160,4160,3640,520,2664,33.3
36047043700,5240,5240,1918,3322,1516,32.9
36047043800,2481,2481,2263,218,2080,32
36047043900,3829,3829,939,2890,1144,36.5
36047044000,2880,2880,2576,304,2475,48.5
36047044100,5643,5643,1350,4293,2089,29.8
36047044200,2658,2658,2475,183,2480,36.3
36047044300,5557,5557,1488,4069,2283,29.4
36047044400,3336,3336,2998,338,2878,31
36047044500,4446,4446,1622,2824,1554,31.8
36047044600,1909,1909,1600,309,1068,29
36047044700,2310,2310,1012,1298,1068,20.1
36047044800,1915,1915,1800,115,1677,31.6
36047044900,2932,2932,1654,1278,1172,33.8
36047045000,673,673,626,47,634,0
36047045200,2701,2701,2635,66,2596,37.5
36047045300,2017,2017,999,1018,968,42.9
36047045400,1852,1852,1680,172,1573,32.5
36047045600,2357,2357,2210,147,1821,36
36047045800,1490,1490,1455,35,1452,52
36047046000,3729,3729,3356,373,2033,34.5
36047046201,2632,2632,2393,239,2050,33
36047046202,1803,1803,1630,173,1601,40.8
36047046400,2838,2838,2690,148,2653,31
36047046800,2054,2054,1986,68,1947,43
36047047000,2886,2886,2851,35,2834,58
36047047200,3141,3141,3104,37,3087,10
36047047400,2969,2969,2931,38,2935,25.5
36047047600,3646,3646,3486,160,3435,32
36047047700,3318,3318,2784,534,2643,34.1
36047047800,4848,4848,3891,957,3718,33
36047048000,3769,3769,3209,560,2734,37.6
36047048100,2778,2778,1925,853,1978,33.5
36047048200,5331,5331,4658,673,2940,37.3
36047048400,5481,5481,4658,823,4035,34.3
36047048500,2510,2510,1625,885,1680,27.5
36047048600,3568,3568,2593,975,1191,36.5
36047048800,4395,4395,3686,709,2384,46.2
36047048900,4039,4039,1662,2377,1177,26.1
36047049000,5899,5899,5116,783,3781,40.8
36047049100,6418,6418,3970,2448,2086,45
36047049200,3495,3495,2769,726,1635,39.7
36047049300,7625,7625,2713,4912,3484,28.9
36047049400,5308,5308,4585,723,3204,43.7
36047049500,2603,2603,1856,747,1907,32.8
36047049600,4513,4513,3465,1048,2039,29.9
36047049700,2645,2645,2423,222,2316,31.5
36047049800,4232,4232,3509,723,2055,30.8
36047049900,1753,1753,1525,228,1507,35.5
36047050000,3474,3474,2957,517,2354,43.1
36047050100,2786,2786,2317,469,2313,39.4
36047050202,2201,2201,1922,279,1802,38.5
36047050300,2582,2582,1867,715,1945,29
36047050400,4527,4527,3742,785,2755,41.6
36047050500,4163,4163,2051,2112,1735,38.6
36047050600,6016,6016,3527,2489,1434,36.6
36047050700,2288,2288,1741,547,1809,26.7
36047050801,4080,4080,3215,865,314,35.3
36047050803,2464,2464,2071,393,323,36.7
36047050804,6250,6250,4182,2068,969,36.2
36047050900,3694,3694,3374,320,3455,38.5
36047051001,3926,3926,3305,621,282,34.6
36047051002,4725,4725,3698,1027,454,35.8
36047051100,3933,3933,2139,1794,1779,44
36047051200,6398,6398,4844,1554,879,37.1
36047051300,4332,4332,2413,1919,2676,32.9
36047051400,7366,7366,5255,2111,1376,37.8
36047051500,1372,1372,1139,233,1064,33.3
36047051601,5732,5732,4593,1139,443,32.9
36047051602,4028,4028,3200,828,382,35.7
36047051700,1735,1735,1542,193,1445,33.5
36047051800,3415,3415,2915,500,915,39.1
36047051900,3564,3564,2886,678,2841,35
36047052000,4228,4228,3333,895,1215,39.4
36047052300,5469,5469,1926,3543,2824,37.5
36047052500,3499,3499,2470,1029,2570,28
36047052600,4357,4357,3654,703,1829,37.8
36047052700,6629,6629,1809,4820,3058,32.6
36047052800,1818,1818,1622,196,983,39.4
36047052900,3979,3979,3664,315,3757,46.5
36047053000,3465,3465,3077,388,2251,37.1
36047053100,7027,7027,6756,271,6890,29
36047053200,2579,2579,2360,219,1632,40.5
36047053300,6566,6566,6408,158,6478,50.5
36047053400,4383,4383,4038,345,2847,46.3
36047053500,4348,4348,4034,314,4120,30.5
36047053700,3575,3575,3537,38,3530,72.5
36047053800,4473,4473,4186,287,3688,33.3
36047053900,2756,2756,2396,360,2393,36.8
36047054200,4450,4450,4043,407,3812,34.5
36047054300,327,327,296,31,232,41.8
36047054400,3406,3406,3315,91,2824,28
36047054500,8008,8008,6054,1954,6225,28.9
36047054600,4346,4346,4100,246,3713,35.6
36047054700,5245,5245,4340,905,4186,28
36047054800,1989,1989,1939,50,1902,35.5
36047054900,3122,3122,2584,538,2517,30.8
36047055000,3551,3551,3269,282,2999,39.8
36047055100,4597,4597,2280,2317,2787,33.8
36047055200,3498,3498,3255,243,2656,32.8
36047055300,2596,2596,2033,563,1933,32.5
36047055400,4216,4216,3818,398,3354,33.5
36047055500,1959,1959,1631,328,1394,35.2
36047055600,3712,3712,3554,158,3149,42.7
36047055700,1655,1655,1453,202,1393,31.5
36047055800,2390,2390,2181,209,1869,33.5
36047056000,3493,3493,3343,150,3188,43.5
36047056100,3295,3295,2928,367,2830,39.5
36047056200,1654,1654,1632,22,1487,60.3
36047056300,4360,4360,3203,1157,3144,40.8
36047056400,2451,2451,2322,129,2025,40.2
36047056500,3255,3255,2757,498,2753,33.8
36047056600,2419,2419,2289,130,1706,39.3
36047056800,1314,1314,1220,94,978,32.5
36047056900,1630,1630,1456,174,1418,30.8
36047057000,3384,3384,3130,254,2311,59.5
36047057100,4400,4400,4169,231,4065,27.6
36047057200,5443,5443,4006,1437,1344,25.4
36047057300,2608,2608,2413,195,2312,32
36047057400,2657,2657,2504,153,1451,33.5
36047057500,4249,4249,3372,877,3395,34.6
36047057600,2918,2918,2764,154,1463,33.3
36047057800,3176,3176,2786,390,1951,33.5
36047057900,1117,1117,643,474,710,34.3
36047058000,3365,3365,3008,357,1778,30.7
36047058200,2967,2967,2627,340,1895,29.5
36047058400,3620,3620,3453,167,2816,29.5
36047058600,2519,2519,2313,206,812,41.5
36047058800,3245,3245,3013,232,2513,40.5
36047058900,1904,1904,1782,122,1748,33.5
36047059000,1899,1899,1651,248,877,50.1
36047059100,3920,3920,3545,375,3531,33
36047059200,3870,3870,3681,189,2596,37.5
36047059300,2228,2228,1827,401,1885,34.5
36047059401,7628,7628,7254,374,4836,34.7
36047059402,4551,4551,4355,196,3681,34.9
36047059600,2306,2306,2201,105,2013,50.5
36047059800,3427,3427,3218,209,2862,42.7
36047060000,6067,6067,5683,384,5185,38.7
36047060600,2555,2555,2328,227,1958,52.8
36047060800,3574,3574,3341,233,2957,36
36047061002,4508,4508,4435,73,4402,47.5
36047061003,1984,1984,1182,802,751,38.5
36047061004,6447,6447,6048,399,5816,40.5
36047061200,1076,1076,1051,25,1042,40.5
36047061600,1656,1656,1615,41,1585,75.8
36047062000,1850,1850,1821,29,1787,38
36047062200,3252,3252,3005,247,2722,24
36047062600,2788,2788,2467,321,1854,31.1
36047062800,5226,5226,4858,368,4937,43.5
36047063200,1447,1447,1337,110,1291,29.8
36047063600,1236,1236,1121,115,1111,36.5
36047063800,1524,1524,1444,80,1326,44.5
36047064000,1599,1599,1481,118,1408,22.5
36047064200,2518,2518,2272,246,2167,27.8
36047064400,2528,2528,2300,228,2093,29.7
36047064600,2189,2189,2018,171,1807,44.1
36047064800,1945,1945,1749,196,1264,30.3
36047065000,1389,1389,1174,215,530,35.2
36047065200,1232,1232,1098,134,959,34
36047065400,1607,1607,1509,98,1472,55.5
36047065600,1708,1708,1586,122,1535,20.5
36047065800,1762,1762,1635,127,1552,24.5
36047066000,1773,1773,1603,170,1589,27.5
36047066200,1411,1411,1218,193,1118,31
36047066600,0,0,0,0,0,0
36047067000,2680,2680,2347,333,845,33.5
36047067200,1422,1422,1216,206,242,34.5
36047067400,1964,1964,1755,209,445,35.7
36047067600,1657,1657,1519,138,220,38.2
36047067800,2660,2660,2542,118,397,35.6
36047068000,1809,1809,1575,234,382,33.1
36047068200,2432,2432,2113,319,683,32.8
36047068600,1533,1533,1394,139,931,35.8
36047068800,1614,1614,1428,186,634,38.8
36047069000,1791,1791,1549,242,475,34.7
36047069200,2392,2392,2156,236,407,34.3
36047069601,3780,3780,3345,435,2003,33.8
36047069602,5995,5995,5520,475,4271,36.1
36047069800,1277,1277,1191,86,1114,37.4
36047070000,1703,1703,1620,83,1623,32.5
36047070201,6573,6573,6362,211,6260,35.5
36047070202,37,37,37,0,25,31.5
36047070203,0,0,0,0,0,0
36047070600,2700,2700,2551,149,2577,68.5
36047072000,2167,2167,2051,116,195,32.2
36047072200,2655,2655,2500,155,110,40.5
36047072400,1755,1755,1665,90,52,39.8
36047072600,2093,2093,1952,141,73,37.7
36047072800,3193,3193,2976,217,293,41
36047073000,1979,1979,1873,106,209,40
36047073200,2096,2096,1928,168,166,37.9
36047073400,1889,1889,1725,164,103,36.9
36047073600,3368,3368,3058,310,443,35.5
36047073800,3225,3225,2835,390,1191,35.1
36047074000,3531,3531,3114,417,372,35.6
36047074200,3292,3292,3062,230,1493,37.5
36047074400,2492,2492,2421,71,2293,34.8
36047074600,2003,2003,1835,168,1357,41.1
36047074800,2012,2012,1909,103,1519,39
36047075000,3029,3029,2885,144,2506,33
36047075200,1130,1130,1128,2,1118,54
36047075400,1488,1488,1483,5,1488,0
36047075600,1993,1993,1924,69,1740,38.5
36047075800,1816,1816,1763,53,1724,45
36047076000,2776,2776,2652,124,2444,42.5
36047076200,4235,4235,3563,672,2657,38.8
36047076400,3487,3487,2867,620,878,35.8
36047076600,2061,2061,1823,238,196,35.7
36047076800,3407,3407,3160,247,2782,36
36047077000,2722,2722,2295,427,347,38.2
36047077200,3394,3394,2980,414,1376,36.6
36047077400,2881,2881,2522,359,753,32.3
36047077600,3806,3806,3492,314,353,39.9
36047078000,2092,2092,2000,92,96,38.9
36047078200,3864,3864,3675,189,69,36.1
36047078400,2348,2348,2162,186,126,38.1
36047078600,4256,4256,3747,509,298,37.1
36047078800,3422,3422,3092,330,89,35.1
36047079000,5094,5094,4681,413,127,36.2
36047079200,4372,4372,3790,582,251,32.6
36047079400,1864,1864,1648,216,71,35.1
36047079601,4413,4413,3789,624,778,37.6
36047079602,4814,4814,4155,659,356,36.4
36047079801,3037,3037,2786,251,561,43.3
36047079802,5451,5451,4831,620,880,38.3
36047080000,3487,3487,3220,267,548,39.9
36047080200,4304,4304,3936,368,273,38.5
36047080400,3250,3250,3005,245,275,34.9
36047080600,3386,3386,3208,178,937,36.4
36047080800,1197,1197,1070,127,138,54.7
36047081000,2300,2300,2144,156,85,36.7
36047081400,2635,2635,2504,131,51,40.6
36047081600,2791,2791,2620,171,58,35.8
36047081800,4551,4551,4071,480,279,36
36047082000,5281,5281,4729,552,152,35.2
36047082200,7280,7280,6547,733,327,38.8
36047082400,4730,4730,4319,411,105,35.1
36047082600,5513,5513,5060,453,148,37.6
36047082800,3814,3814,3446,368,112,35.7
36047083000,5997,5997,5541,456,109,33.4
36047083200,2289,2289,2179,110,38,38.1
36047083400,1701,1701,1626,75,32,41.7
36047083600,1929,1929,1841,88,42,39.5
36047083800,2189,2189,2059,130,54,40.4
36047084000,2412,2412,2240,172,105,42.1
36047084600,1963,1963,1868,95,58,41.5
36047084800,1750,1750,1670,80,17,39.3
36047085000,1374,1374,1327,47,55,40.8
36047085200,29,29,28,1,0,36
36047085400,2052,2052,1911,141,34,37.7
36047085600,3608,3608,3348,260,69,36.9
36047085800,2434,2434,2343,91,35,36.4
36047086000,3426,3426,3224,202,72,37.1
36047086200,2996,2996,2855,141,59,36.3
36047086400,2231,2231,2137,94,27,39.3
36047086600,3149,3149,3021,128,40,39
36047086800,3156,3156,3020,136,91,37.7
36047087000,3204,3204,3043,161,85,39
36047087200,2868,2868,2730,138,25,40.4
36047087401,3142,3142,2865,277,290,41.5
36047087600,1742,1742,1655,87,323,38.6
36047087800,3006,3006,2841,165,93,41
36047088000,2863,2863,2687,176,68,40
36047088200,6740,6740,6357,383,60,35.9
36047088400,5236,5236,4977,259,69,33.2
36047088600,4427,4427,4087,340,87,35.5
36047088800,3923,3923,3553,370,123,36.5
36047089000,6319,6319,5770,549,140,36.3
36047089200,3651,3651,3307,344,92,33.7
36047089400,3430,3430,3051,379,120,33.5
36047089600,3546,3546,3209,337,108,31.9
36047089800,2089,2089,1904,185,79,32.5
36047090000,5508,5508,4469,1039,197,29.6
36047090200,3451,3451,2720,731,231,29.6
36047090600,4581,4581,3225,1356,297,25.6
36047090800,3990,3990,2809,1181,421,26.5
36047091000,5610,5610,3916,1694,532,29.4
36047091200,6814,6814,4836,1978,538,26.5
36047091600,4325,4325,3684,641,148,30.8
36047091800,2804,2804,1765,1039,268,33.6
36047092000,3154,3154,2728,426,146,28.5
36047092200,2691,2691,2480,211,60,41
36047092400,2656,2656,2214,442,95,29.5
36047092800,2656,2656,2493,163,72,38.9
36047093000,2547,2547,2485,62,25,42.2
36047093200,1142,1142,1085,57,23,43.3
36047093400,2401,2401,2310,91,48,43.4
36047093600,1628,1628,1526,102,32,40.9
36047093800,2374,2374,2278,96,19,36.6
36047094401,3202,3202,3072,130,63,40.3
36047094402,2886,2886,2423,463,296,28.2
36047094600,1830,1830,1721,109,45,41.8
36047095000,2906,2906,2807,99,105,35.8
36047095400,4607,4607,4428,179,176,36.7
36047095600,4042,4042,3802,240,234,34.5
36047095800,3456,3456,3254,202,207,34.6
36047096000,0,0,0,0,0,0
36047096200,1717,1717,1550,167,155,31.8
36047096400,2361,2361,2170,191,193,32.6
36047096600,2164,2164,1985,179,218,35.4
36047096800,1471,1471,1274,197,217,33.3
36047097000,2105,2105,1860,245,302,34.3
36047097400,2724,2724,2442,282,318,36.5
36047098200,4305,4305,3271,1034,351,28.5
36047098400,1978,1978,1908,70,70,35.9
36047098600,2862,2862,2713,149,52,35
36047098800,3054,3054,2806,248,323,39.9
36047099000,1422,1422,1282,140,154,35.1
36047099200,1833,1833,1709,124,178,35.6
36047099400,1978,1978,1863,115,127,32.9
36047099600,3631,3631,3460,171,220,34.5
36047099800,3784,3784,3600,184,280,35.6
36047100400,2567,2567,2435,132,172,35.9
36047100600,2489,2489,2320,169,211,35.1
36047100800,2124,2124,1976,148,242,32.6
36047101000,2318,2318,2156,162,292,33
36047101200,1932,1932,1811,121,203,33.1
36047101400,2160,2160,1995,165,137,36.2
36047101600,1464,1464,1402,62,79,34.5
36047101800,1851,1851,1712,139,161,38.4
36047102000,1922,1922,1841,81,166,38
36047102200,2075,2075,1899,176,228,33.9
36047102400,2123,2123,1959,164,220,31.8
36047102600,2771,2771,2633,138,110,36
36047102800,1579,1579,1430,149,90,35.4
36047103400,3918,3918,2999,919,605,26.3
36047105801,6928,6928,5663,1265,2229,36.3
36047105804,6426,6426,5307,1119,1966,37.4
36047107000,322,322,275,47,11,40.2
36047107800,3849,3849,3552,297,122,44.2
36047109800,1917,1917,1660,257,155,28.3
36047110400,4358,4358,3627,731,277,32.9
36047110600,4311,4311,3285,1026,267,28.8
36047111000,3216,3216,2485,731,253,32.7
36047111600,3484,3484,2812,672,239,34.6
36047111800,3053,3053,2281,772,305,30.7
36047112000,3155,3155,2104,1051,275,36
36047112200,3371,3371,2702,669,212,32.4
36047112400,3416,3416,2793,623,165,29.5
36047112600,3783,3783,2856,927,285,31
36047112800,3822,3822,3005,817,299,32.9
36047113000,3891,3891,3052,839,169,29.8
36047113200,1937,1937,1594,343,79,33.8
36047113400,2838,2838,1887,951,302,23.4
36047114201,1578,1578,520,1058,432,36.5
36047114202,2766,2766,1113,1653,567,33.7
36047114400,2403,2403,1497,906,294,28.6
36047114600,2998,2998,1121,1877,660,27.5
36047115000,2595,2595,1451,1144,343,28
36047115200,3094,3094,2123,971,258,26.2
36047115600,4315,4315,2769,1546,472,26.4
36047115800,2983,2983,2136,847,270,32.3
36047116000,2543,2543,1797,746,217,30.8
36047116200,2157,2157,1746,411,99,35.2
36047116400,2921,2921,2068,853,196,34.4
36047116600,2907,2907,1687,1220,315,27.9
36047116800,2057,2057,808,1249,413,26.8
36047117000,1880,1880,656,1224,364,32
36047117201,2713,2713,816,1897,651,32.5
36047117202,3907,3907,1402,2505,926,30.7
36047117400,4329,4329,1377,2952,1119,29.9
36047117601,2750,2750,840,1910,688,30.8
36047117602,3313,3313,1077,2236,962,28.2
36047117800,1717,1717,758,959,414,29.9
36047118000,6,6,6,0,0,29.5
36047118201,3002,3002,933,2069,764,29.6
36047118202,3083,3083,929,2154,803,31.3
36047118400,5420,5420,1736,3684,1652,30.8
36047118600,2969,2969,1269,1700,690,29.8
36047118800,4651,4651,2933,1718,757,28
36047119000,2127,2127,1221,906,315,27
36047119200,3013,3013,1559,1454,451,29.7
36047119400,3914,3914,2695,1219,314,30
36047119600,5403,5403,3801,1602,542,30.8
36047119800,3426,3426,1483,1943,776,30.3
36047120000,2148,2148,1555,593,229,35
36047120200,1900,1900,1483,417,160,30.1
36047120800,8938,8938,7129,1809,751,33
36047121000,4035,4035,2087,1948,616,27.9
36047121400,4351,4351,2734,1617,471,26.6
36047122000,5495,5495,4453,1042,344,29.3
36047123700,6008,6008,5020,988,5018,31.5
36047150200,2540,2540,2101,439,1971,33.4
36047152200,3317,3317,2789,528,1445,41.8
36047990100,0,0,0,0,0,0
36061000100,2,2,2,0,0,0
36061000201,3058,3058,1794,1264,777,30.3
36061000202,7316,7316,4351,2965,3165,41.1
36061000500,0,0,0,0,0,0
36061000600,11367,11367,8950,2417,1708,33.2
36061000700,8109,8109,7523,586,5696,29.7
36061000800,10290,10290,10075,215,964,36.3
36061000900,731,731,681,50,578,33
36061001001,1434,1434,1223,211,1178,53.5
36061001002,6547,6547,2347,4200,1815,26.9
36061001200,3397,3397,2308,1089,2200,38.3
36061001300,4479,4479,4140,339,3084,29.8
36061001401,3005,3005,2595,410,2315,52.1
36061001402,2782,2782,1815,967,1142,30.5
36061001501,5518,5518,5050,468,3611,42.8
36061001502,7476,7476,6910,566,5319,26.2
36061001600,8478,8478,8203,275,1117,32.5
36061001800,8660,8660,7540,1120,2338,48.9
36061002000,4917,4917,1639,3278,1465,31.3
36061002100,6040,6040,5700,340,4719,28.4
36061002201,6398,6398,3606,2792,2349,38.5
36061002202,2189,2189,1714,475,1330,44.8
36061002400,5434,5434,2157,3277,1881,30.7
36061002500,4869,4869,2849,2020,965,28.6
36061002601,3772,3772,2094,1678,1678,40.8
36061002602,4227,4227,3292,935,2590,41.2
36061002700,1264,1264,1244,20,254,57
36061002800,7114,7114,4202,2912,3559,38.1
36061002900,6398,6398,5804,594,917,36.1
36061003001,4492,4492,3501,991,2732,36.3
36061003002,3106,3106,2316,790,2002,41.5
36061003100,2550,2550,2336,214,1550,36.5
36061003200,8234,8234,7397,837,6217,43.1
36061003300,5156,5156,4965,191,4389,38.8
36061003400,6612,6612,5505,1107,4865,40.9
36061003601,3393,3393,2208,1185,1424,41.6
36061003602,3151,3151,2661,490,2075,43.6
36061003700,2447,2447,2297,150,2141,39
36061003800,9237,9237,8256,981,6813,33.2
36061003900,5860,5860,5374,486,4806,52.3
36061004000,8651,8651,7823,828,6615,39.3
36061004100,7817,7817,7499,318,2445,30
36061004200,5145,5145,4715,430,3281,21.8
36061004300,4270,4270,3717,553,2750,29
36061004400,16538,16538,15332,1206,12772,46.8
36061004500,1136,1136,1070,66,851,36.3
36061004700,2524,2524,2340,184,2141,38.5
36061004800,7229,7229,6650,579,5527,35.8
36061004900,4942,4942,4674,268,4286,35.5
36061005000,5055,5055,4786,269,4228,40.5
36061005200,3408,3408,3232,176,2696,27
36061005400,4536,4536,4218,318,3778,52.4
36061005501,4204,4204,3930,274,3355,41.2
36061005502,2257,2257,2076,181,1787,45
36061005600,3322,3322,3013,309,2415,42.1
36061005700,2781,2781,2670,111,2413,47.5
36061005800,3512,3512,3229,283,2595,35.4
36061005900,5401,5401,5151,250,4545,35.1
36061006000,4511,4511,4312,199,3848,41.8
36061006100,5224,5224,4890,334,3977,23
36061006200,4437,4437,3773,664,2367,47.3
36061006300,6380,6380,6097,283,5699,46.3
36061006400,8090,8090,7475,615,6420,43.3
36061006500,6202,6202,5741,461,5079,29.3
36061006600,11740,11740,9552,2188,7583,37
36061006700,5461,5461,5083,378,4753,36.8
36061006800,7614,7614,7054,560,5777,50.4
36061006900,2759,2759,2598,161,2393,43.5
36061007000,8871,8871,8236,635,6763,40.3
36061007100,5429,5429,5118,311,4698,45.2
36061007200,8664,8664,8189,475,7104,44.4
36061007300,6215,6215,5865,350,5530,45.3
36061007400,4319,4319,4069,250,3324,49.3
36061007500,4159,4159,3934,225,3708,49
36061007600,2277,2277,2130,147,1232,41.8
36061007700,5966,5966,5498,468,5265,44.4
36061007800,8391,8391,7854,537,6068,39.3
36061007900,4442,4442,4175,267,3829,62.5
36061008000,5377,5377,5078,299,4486,44.1
36061008100,8047,8047,7093,954,6610,45.9
36061008200,3262,3262,3052,210,2538,35.9
36061008300,4092,4092,2828,1264,2503,32.6
36061008400,1595,1595,1496,99,778,35.8
36061008601,2618,2618,2482,136,1868,42
36061008602,0,0,0,0,0,0
36061008603,4799,4799,4579,220,4369,59.8
36061008700,6338,6338,5573,765,5087,41.7
36061008800,7026,7026,6565,461,5240,50
36061008900,5708,5708,4753,955,4295,32.8
36061009000,7883,7883,7346,537,5831,43.8
36061009100,6304,6304,5679,625,4768,46.9
36061009200,1806,1806,1674,132,1230,33.8
36061009300,8780,8780,7168,1612,6711,39.3
36061009400,73,73,69,4,58,50.5
36061009500,3040,3040,2772,268,2404,23.8
36061009600,155,155,139,16,104,47.5
36061009700,5224,5224,3913,1311,3135,41.8
36061009800,7316,7316,6889,427,5985,44
36061009900,1945,1945,1698,247,1442,39
36061010000,1992,1992,1825,167,1490,48.1
36061010100,1116,1116,977,139,545,50.7
36061010200,230,230,208,22,176,49.2
36061010300,2058,2058,1870,188,1341,44.1
36061010400,966,966,912,54,800,55.5
36061010601,7351,7351,7084,267,6814,48.4
36061010602,4875,4875,4600,275,3771,39.8
36061010800,9039,9039,8511,528,7765,33.9
36061010900,183,183,178,5,77,30.5
36061011000,7169,7169,6688,481,6099,34.3
36061011100,3512,3512,2836,676,2243,40.7
36061011201,992,992,947,45,867,48
36061011202,441,441,412,29,373,18.5
36061011203,1401,1401,1319,82,1199,43.3
36061011300,117,117,109,8,60,49.3
36061011401,1412,1412,1342,70,1283,37
36061011402,2397,2397,2292,105,2156,40
36061011500,2303,2303,1841,462,1248,30
36061011600,3543,3543,3231,312,2678,35.3
36061011700,3364,3364,2804,560,1960,30.4
36061011800,8767,8767,8342,425,7870,40
36061011900,1120,1120,917,203,565,58.6
36061012000,3971,3971,3801,170,3639,51.5
36061012100,8554,8554,7181,1373,6201,50.8
36061012200,3633,3633,3393,240,3346,42.8
36061012400,10218,10218,9536,682,8333,30.9
36061012500,2719,2719,2445,274,1442,40.4
36061012600,12774,12774,12136,638,11505,49
36061012700,6928,6928,5315,1613,4672,44.9
36061012800,6270,6270,6014,256,5898,48.5
36061012900,6038,6038,4928,1110,3782,36.1
36061013000,4195,4195,4027,168,3944,47.3
36061013100,2816,2816,2407,409,1943,36.6
36061013200,10590,10590,9872,718,8924,36.8
36061013300,6208,6208,4991,1217,4125,40.2
36061013400,11174,11174,10579,595,9708,38.7
36061013500,6596,6596,4419,2177,3700,39.5
36061013600,15344,15344,14444,900,13418,39
36061013700,6471,6471,6119,352,5136,41.5
36061013800,12444,12444,11620,824,10677,51
36061013900,9257,9257,8332,925,6981,50.1
36061014000,7813,7813,7434,379,7058,40.6
36061014200,4462,4462,4300,162,4203,49.5
36061014300,25,25,19,6,6,42
36061014401,4864,4864,4620,244,4335,41.5
36061014402,6743,6743,6327,416,5854,37.8
36061014500,5542,5542,5038,504,4179,30.4
36061014601,4274,4274,3987,287,3451,37.8
36061014602,7904,7904,7416,488,6712,42.5
36061014700,2755,2755,2535,220,1707,30.9
36061014801,2863,2863,2741,122,2522,45.5
36061014802,7066,7066,6687,379,6111,39.2
36061014900,5842,5842,5533,309,4895,43.8
36061015001,2294,2294,2225,69,2146,46
36061015002,5437,5437,5220,217,5065,46.5
36061015100,8306,8306,6112,2194,4071,39.5
36061015200,7275,7275,5748,1527,4771,32.1
36061015300,9320,9320,8801,519,7996,52.3
36061015400,13749,13749,12249,1500,10543,45.9
36061015500,9350,9350,8891,459,7875,42
36061015601,5345,5345,4664,681,3827,38.3
36061015602,2298,2298,1452,846,1009,34.8
36061015700,10751,10751,10099,652,9327,42.7
36061015801,5650,5650,5304,346,5050,36
36061015802,3346,3346,2768,578,2191,31.2
36061015900,9623,9623,9163,460,8330,51.1
36061016001,3744,3744,3593,151,3498,47
36061016002,3131,3131,2709,422,2384,29.5
36061016100,6437,6437,6053,384,5625,51.7
36061016200,9308,9308,5092,4216,1951,37.7
36061016300,6624,6624,6199,425,5779,51.6
36061016400,6127,6127,2747,3380,1949,29.3
36061016500,6402,6402,5886,516,5558,54.8
36061016600,7317,7317,3100,4217,2984,31.4
36061016700,6564,6564,6086,478,5761,45.5
36061016800,5675,5675,2944,2731,2075,44.4
36061016900,8108,8108,7150,958,6748,51
36061017000,7855,7855,3400,4455,2426,41.8
36061017100,8989,8989,8233,756,7628,51.9
36061017200,5504,5504,2024,3480,1710,31.7
36061017300,8939,8939,7528,1411,7033,50
36061017401,5248,5248,2892,2356,1341,36.1
36061017402,2093,2093,1275,818,455,33.3
36061017500,10820,10820,9955,865,9135,67.4
36061017700,9151,9151,6695,2456,5845,49.3
36061017800,3912,3912,1710,2202,1658,33.3
36061017900,9293,9293,8009,1284,7159,47.1
36061018000,7476,7476,2629,4847,2310,29.6
36061018100,8866,8866,7411,1455,6016,53.8
36061018200,6768,6768,2520,4248,1737,31.2
36061018300,8667,8667,7399,1268,6682,48.6
36061018400,7835,7835,3741,4094,1801,34.4
36061018500,4190,4190,3830,360,2955,60.9
36061018600,5701,5701,3762,1939,925,36
36061018700,8974,8974,7577,1397,6683,41.3
36061018800,6008,6008,2020,3988,1895,35
36061018900,11547,11547,6606,4941,4841,42.7
36061019000,3083,3083,2515,568,670,38.5
36061019100,8807,8807,7296,1511,6348,45.5
36061019200,3584,3584,1613,1971,879,30.4
36061019300,9009,9009,4968,4041,3759,42.4
36061019400,6558,6558,2570,3988,1574,31.4
36061019500,8197,8197,6448,1749,5677,43.9
36061019600,3931,3931,2079,1852,986,42.5
36061019701,641,641,551,90,383,30.3
36061019702,2090,2090,1693,397,639,41.3
36061019800,1914,1914,1563,351,410,45.9
36061019900,10064,10064,8749,1315,6774,34.5
36061020000,2581,2581,2248,333,616,41.7
36061020101,1731,1731,1520,211,1045,21.5
36061020102,3865,3865,2975,890,895,35.9
36061020300,3633,3633,3121,512,2015,20.8
36061020500,5322,5322,4793,529,3714,25.8
36061020600,2942,2942,2301,641,420,36.8
36061020701,3329,3329,2987,342,2257,30.5
36061020800,4591,4591,3925,666,756,36.5
36061020901,3673,3673,2041,1632,598,38.5
36061021000,6637,6637,5036,1601,452,42.3
36061021100,10330,10330,7596,2734,4801,38.7
36061021200,4412,4412,3832,580,395,45.6
36061021303,5619,5619,3505,2114,1145,38
36061021400,3001,3001,2741,260,221,47
36061021500,3068,3068,2380,688,282,34.1
36061021600,7556,7556,5839,1717,1885,37.8
36061021703,6,6,6,0,3,21.5
36061021800,6617,6617,5460,1157,1137,39.9
36061021900,6023,6023,2379,3644,1134,32.6
36061022000,5370,5370,4387,983,1077,35.2
36061022102,2175,2175,1846,329,343,42.5
36061022200,2644,2644,2150,494,529,34.2
36061022301,7917,7917,1510,6407,2454,33.8
36061022302,3385,3385,1137,2248,718,39.7
36061022400,6427,6427,4526,1901,749,34
36061022500,10149,10149,3536,6613,2726,39.7
36061022600,3778,3778,3175,603,412,36.6
36061022700,4864,4864,3448,1416,985,41.8
36061022800,5248,5248,4456,792,576,35.9
36061022900,8300,8300,2930,5370,2062,39.3
36061023000,8106,8106,6542,1564,774,34.8
36061023100,5865,5865,3818,2047,1262,42.2
36061023200,7980,7980,5518,2462,734,32.3
36061023300,6527,6527,3052,3475,1593,40.6
36061023400,4465,4465,3396,1069,603,33.6
36061023501,6004,6004,3472,2532,1108,40.5
36061023502,1819,1819,1486,333,178,32.8
36061023600,6404,6404,5410,994,219,41.3
36061023700,6811,6811,2940,3871,1633,39
36061023801,9723,9723,8345,1378,4897,44.9
36061023802,1938,1938,1580,358,1055,56.4
36061023900,2371,2371,1220,1151,454,40.1
36061024000,1648,1648,1099,549,430,44.5
36061024100,7642,7642,3421,4221,2113,48.2
36061024200,3396,3396,1937,1459,433,32.9
36061024301,3946,3946,1678,2268,915,40.2
36061024302,7370,7370,4203,3167,874,33.5
36061024500,14934,14934,2732,12202,3666,37.6
36061024700,7074,7074,1884,5190,2206,45.7
36061024900,1101,1101,303,798,235,39.5
36061025100,2526,2526,548,1978,693,37.9
36061025300,11236,11236,2243,8993,3628,37.6
36061025500,5771,5771,3073,2698,2786,32.5
36061025700,3876,3876,3209,667,1083,38.8
36061025900,3496,3496,2357,1139,725,32.9
36061026100,12087,12087,1092,10995,2712,38.1
36061026300,8729,8729,1341,7388,2698,42.2
36061026500,7021,7021,2372,4649,3485,39.8
36061026700,2173,2173,1415,758,1603,42.4
36061026900,8428,8428,1116,7312,2591,41.4
36061027100,8196,8196,2454,5742,3729,37.9
36061027300,6370,6370,4658,1712,4694,43.3
36061027500,2846,2846,2398,448,2229,48.2
36061027700,7086,7086,1087,5999,1974,52.6
36061027900,10292,10292,2389,7903,3819,38.6
36061028100,2867,2867,2481,386,2344,62
36061028300,7627,7627,2299,5328,2837,43.7
36061028500,7216,7216,1033,6183,2010,36.8
36061028700,4035,4035,1396,2639,1877,37.2
36061029100,11288,11288,1181,10107,2850,38.3
36061029300,9033,9033,1010,8023,2616,37.6
36061029500,6941,6941,3040,3901,3591,37.9
36061029700,161,161,80,81,77,46.5
36061029900,3834,3834,983,2851,879,39.2
36061030300,3753,3753,1650,2103,1886,36.3
36061030700,3434,3434,2467,967,2342,46.7
36061030900,8463,8463,2558,5905,2114,37.3
36061031100,2,2,0,2,2,0
36061031703,7709,7709,7145,564,5979,35.2
36061031704,5677,5677,5195,482,3731,38
36061031900,11,11,9,2,4,50.5
36081000100,4949,4949,4464,485,3144,42.1
36081000200,2829,2829,1292,1537,1179,30.3
36081000400,4413,4413,1518,2895,1501,30.5
36081000600,3729,3729,1427,2302,1427,30.3
36081000700,4790,4790,3623,1167,3097,39.1
36081000800,3360,3360,1282,2078,1358,30.7
36081001000,3502,3502,1502,2000,1249,30.3
36081001200,3871,3871,1832,2039,1706,31.4
36081001400,3683,3683,1541,2142,1916,36.2
36081001600,2831,2831,1128,1703,1155,32.9
36081001800,2931,2931,1283,1648,1236,32.5
36081001900,1076,1076,855,221,707,36
36081002000,1797,1797,858,939,698,30.3
36081002200,2077,2077,876,1201,876,37.8
36081002400,2145,2145,908,1237,870,33.7
36081002500,7571,7571,4577,2994,1353,31.4
36081002600,2055,2055,1094,961,844,30.8
36081002800,3033,3033,1309,1724,1167,32.1
36081003000,1399,1399,652,747,690,41
36081003100,1388,1388,696,692,662,31.3
36081003200,1504,1504,685,819,558,35
36081003300,2474,2474,1642,832,870,30.8
36081003400,2201,2201,1038,1163,740,33.8
36081003600,3295,3295,1644,1651,1069,28.9
36081003700,0,0,0,0,0,0
36081003800,2287,2287,1045,1242,962,33.8
36081003900,1592,1592,762,830,674,38.1
36081004001,2134,2134,1199,935,995,30.9
36081004002,1270,1270,844,426,341,33
36081004200,4120,4120,2301,1819,1157,31.6
36081004300,2437,2437,1343,1094,685,30.6
36081004401,3500,3500,2520,980,739,33.8
36081004500,2975,2975,2409,566,1957,48.1
36081004700,3984,3984,2571,1413,1588,32.4
36081005000,29,29,6,23,13,0
36081005100,2231,2231,1689,542,885,38.5
36081005200,2751,2751,1696,1055,655,32.8
36081005300,5340,5340,4247,1093,3140,35
36081005400,5257,5257,3143,2114,2020,34.8
36081005500,1067,1067,555,512,468,28.5
36081005700,4321,4321,2870,1451,2413,35.3
36081005800,5414,5414,3116,2298,3119,33.1
36081005900,4169,4169,3134,1035,2858,37.2
36081006100,5644,5644,4385,1259,3680,33.1
36081006201,5128,5128,4032,1096,4326,46.5
36081006202,6253,6253,4332,1921,4592,30.9
36081006300,5949,5949,4572,1377,4015,29.7
36081006501,3676,3676,2843,833,2465,31
36081006502,3853,3853,2916,937,2736,30.8
36081006900,4611,4611,3153,1458,2716,42.5
36081007100,3963,3963,3124,839,2470,31.5
36081007300,4231,4231,3371,860,2766,36.3
36081007500,4116,4116,3116,1000,2726,40.5
36081007700,1478,1478,960,518,765,30.4
36081007900,3493,3493,2191,1302,1624,40.5
36081008100,1188,1188,594,594,590,35
36081008300,2950,2950,1683,1267,1396,36.2
36081008500,1270,1270,662,608,567,27.3
36081008600,2811,2811,1697,1114,1728,29.6
36081008700,4582,4582,2626,1956,945,27.4
36081008800,3095,3095,1938,1157,2161,34.2
36081009100,2796,2796,1999,797,1859,40.5
36081009400,2834,2834,2208,626,467,34.2
36081009500,2289,2289,1936,353,1828,36
36081009600,3135,3135,2487,648,518,33.3
36081009700,3580,3580,3167,413,2939,30.5
36081009800,2688,2688,2233,455,331,33.6
36081009900,3,3,3,0,1,52.5
36081010000,3571,3571,2707,864,729,33.3
36081010100,2552,2552,2107,445,2012,30.8
36081010200,2677,2677,2029,648,437,34.6
36081010300,3934,3934,3281,653,2795,35.9
36081010400,3147,3147,2608,539,418,34.5
36081010500,4244,4244,2580,1664,2646,34.9
36081010600,3427,3427,2836,591,381,31.7
36081010701,0,0,0,0,0,0
36081010800,2980,2980,2367,613,373,30.6
36081011000,3075,3075,2190,885,561,33.7
36081011100,3050,3050,2427,623,2085,31.5
36081011200,2358,2358,1678,680,649,35.1
36081011300,4234,4234,3338,896,2981,33.2
36081011400,1330,1330,702,628,420,32
36081011500,2325,2325,1873,452,1734,35.3
36081011600,2178,2178,1354,824,620,30.3
36081011700,3848,3848,3194,654,2994,28.5
36081011800,2628,2628,1736,892,537,39
36081011900,1701,1701,1368,333,1382,33.5
36081012000,2487,2487,1945,542,381,29.5
36081012100,2064,2064,1766,298,1699,42.5
36081012200,2971,2971,1900,1071,790,37.3
36081012301,2910,2910,2498,412,2486,26.5
36081012400,2914,2914,1592,1322,837,30.1
36081012500,1662,1662,1278,384,1175,30
36081012601,2413,2413,1248,1165,801,32.3
36081012602,2578,2578,1170,1408,939,28.5
36081012800,2030,2030,1183,847,1044,32.2
36081013000,1745,1745,1183,562,975,33.7
36081013200,1772,1772,1227,545,1018,32.5
36081013400,5474,5474,4316,1158,3863,36.4
36081013500,1411,1411,1226,185,1290,28.5
36081013600,1972,1972,1454,518,1335,36.9
36081013700,1579,1579,1319,260,1263,29.5
36081013800,3604,3604,2561,1043,1833,32.9
36081014000,3705,3705,2903,802,2312,35.5
36081014100,1621,1621,1234,387,1168,29
36081014201,4348,4348,2445,1903,889,31.1
36081014202,2838,2838,1683,1155,631,46.6
36081014300,4065,4065,2954,1111,2675,32
36081014400,2109,2109,1374,735,478,36.8
36081014500,2246,2246,1814,432,1730,29.3
36081014700,3054,3054,2455,599,2386,28.5
36081014800,2265,2265,1646,619,357,33.8
36081014900,2674,2674,1820,854,1777,33
36081015000,2458,2458,1773,685,379,36.7
36081015100,2794,2794,2068,726,1896,35
36081015200,2721,2721,1963,758,358,33.8
36081015300,2145,2145,1693,452,1356,37.3
36081015400,2333,2333,1878,455,256,33.2
36081015500,2251,2251,1736,515,1461,31.8
36081015600,3218,3218,2790,428,280,33.9
36081015700,1543,1543,982,561,721,34.4
36081015801,3737,3737,3118,619,268,37.6
36081015802,4398,4398,3670,728,390,35.3
36081015900,4136,4136,3151,985,2897,30.7
36081016100,2377,2377,1387,990,1031,27.8
36081016300,4382,4382,2561,1821,1647,30.2
36081016400,3313,3313,2815,498,251,36.1
36081016600,3278,3278,2555,723,410,33.9
36081016800,2684,2684,1987,697,365,35.4
36081016900,5539,5539,4273,1266,3205,41.2
36081017000,2600,2600,2335,265,129,36
36081017100,8,8,6,2,4,0
36081017200,2101,2101,1749,352,122,39.7
36081017400,2244,2244,1836,408,141,39.6
36081017600,2143,2143,1828,315,140,37.5
36081017800,1925,1925,1615,310,156,39.5
36081017900,1054,1054,631,423,493,37
36081018000,1090,1090,906,184,105,37.9
36081018101,4090,4090,2618,1472,1975,36
36081018102,3928,3928,3204,724,2322,37.2
36081018200,2267,2267,1919,348,127,32.6
36081018300,6031,6031,4126,1905,3262,35.9
36081018401,2054,2054,1852,202,52,32.7
36081018402,2223,2223,1994,229,67,38.4
36081018501,3611,3611,2384,1227,1989,37
36081018502,3633,3633,2459,1174,1916,37.8
36081018600,1623,1623,1464,159,47,36.8
36081018700,3088,3088,1992,1096,1465,35.5
36081018800,1236,1236,1094,142,35,37.9
36081018900,3492,3492,2192,1300,1523,43.2
36081019000,1969,1969,1764,205,65,36.8
36081019200,1914,1914,1685,229,69,38.5
36081019400,2628,2628,2222,406,109,40
36081019600,2643,2643,2241,402,163,34.4
36081019800,2930,2930,2329,601,187,31.9
36081019900,1028,1028,566,462,325,35.3
36081020200,1387,1387,1145,242,59,38.7
36081020400,2098,2098,1567,531,212,30.3
36081020500,1202,1202,301,901,533,33.3
36081020600,1712,1712,1094,618,352,30.8
36081020800,2539,2539,1433,1106,651,35.9
36081021200,2754,2754,1156,1598,561,29.8
36081021400,6194,6194,4054,2140,1803,39.8
36081021600,4016,4016,2702,1314,1997,38.7
36081021900,7,7,7,0,4,0
36081022001,6074,6074,4257,1817,3022,33.5
36081022002,5569,5569,4300,1269,2802,36.2
36081022900,27,27,1,26,12,0
36081023000,1795,1795,1304,491,770,32.5
36081023200,5090,5090,3855,1235,1617,40.1
36081023500,8278,8278,3291,4987,2879,40.2
36081023600,2638,2638,1667,971,576,38.2
36081023800,5101,5101,2548,2553,969,37
36081024000,5464,5464,2264,3200,1250,39.1
36081024300,5440,5440,3515,1925,2610,35.5
36081024500,4942,4942,3464,1478,2745,42.2
36081024600,0,0,0,0,0,0
36081024700,1509,1509,937,572,478,31
36081024900,5546,5546,4121,1425,2049,34.8
36081025100,5720,5720,3683,2037,2585,39.7
36081025301,4591,4591,2739,1852,2247,37
36081025302,2876,2876,1546,1330,1317,35
36081025400,8207,8207,6864,1343,391,33
36081025500,1507,1507,975,532,641,33.5
36081025700,1542,1542,1039,503,511,28.5
36081025800,1978,1978,1691,287,100,32.1
36081025900,3516,3516,2186,1330,1095,36.5
36081026000,2339,2339,1849,490,125,27.9
36081026100,7414,7414,4371,3043,1860,33.6
36081026200,1465,1465,1304,161,47,33.6
36081026300,6220,6220,3991,2229,1552,32
36081026400,2257,2257,1927,330,88,38.8
36081026500,4494,4494,3218,1276,839,37.5
36081026600,1755,1755,1581,174,56,47.6
36081026700,6002,6002,3326,2676,1535,42.5
36081026901,5304,5304,2031,3273,1755,43.2
36081026902,4444,4444,2533,1911,1073,42
36081027000,1647,1647,1468,179,89,33.8
36081027100,8726,8726,4202,4524,2323,43.7
36081027200,1846,1846,1646,200,77,32.9
36081027300,8631,8631,1464,7167,2996,42.8
36081027400,1735,1735,1528,207,77,38.2
36081027500,6887,6887,1845,5042,2460,43.1
36081027600,1165,1165,982,183,33,33.7
36081027700,8757,8757,2700,6057,3659,44.3
36081027800,2256,2256,1944,312,96,34.4
36081027900,6317,6317,2137,4180,3371,41.6
36081028000,1551,1551,1431,120,30,36.4
36081028100,5722,5722,2465,3257,3094,40.8
36081028200,1545,1545,1442,103,29,35.1
36081028300,7415,7415,3121,4294,4207,38.9
36081028400,3438,3438,3150,288,70,35.7
36081028500,4729,4729,2875,1854,3107,41
36081028700,6232,6232,3835,2397,3363,41.5
36081028800,4230,4230,3858,372,97,34.5
36081028900,5176,5176,3271,1905,2388,37.2
36081029100,7039,7039,5226,1813,1924,53.9
36081029300,1351,1351,1006,345,325,34
36081029400,6664,6664,5992,672,216,37
36081029500,3670,3670,2697,973,2036,43.4
36081029700,2162,2162,1529,633,1071,28
36081029900,0,0,0,0,0,0
36081030600,4213,4213,3821,392,146,35.2
36081030902,7992,7992,5180,2812,3268,37.8
36081030903,6743,6743,3477,3266,2554,36.8
36081030904,3712,3712,1983,1729,1925,37.5
36081031700,6151,6151,4950,1201,5005,35.1
36081032000,4645,4645,4087,558,235,30.2
36081032700,4255,4255,1357,2898,1759,32.8
36081032800,2409,2409,2275,134,61,35
36081032900,4018,4018,1478,2540,1773,25
36081033000,6170,6170,5719,451,117,36
36081033100,0,0,0,0,0,0
36081033401,3128,3128,2815,313,97,35.1
36081033402,12575,12575,12039,536,163,44.9
36081033700,3619,3619,891,2728,1501,38
36081033900,3400,3400,1240,2160,1673,45.9
36081034700,3268,3268,1132,2136,1160,42.9
36081035100,4240,4240,1354,2886,1994,43.1
36081035200,2414,2414,2232,182,43,37.7
36081035300,2690,2690,590,2100,933,45.6
36081035700,4947,4947,2495,2452,1580,50.3
36081035800,3927,3927,3669,258,65,35.6
36081036100,2426,2426,901,1525,649,46.5
36081036300,2397,2397,699,1698,664,42.7
36081036500,3885,3885,768,3117,1118,41.7
36081036600,2592,2592,2435,157,40,41
36081036700,2676,2676,1322,1354,542,44.6
36081036800,2362,2362,2222,140,20,37.3
36081037100,1597,1597,869,728,283,48.7
36081037300,2532,2532,815,1717,639,44.5
36081037500,3783,3783,662,3121,1237,45.1
36081037600,5598,5598,5266,332,76,38.9
36081037700,4227,4227,652,3575,1127,41
36081037900,6214,6214,959,5255,1658,37.8
36081038100,6808,6808,1443,5365,2033,47.4
36081038301,0,0,0,0,0,0
36081038302,56,56,36,20,31,36.5
36081038400,2333,2333,2234,99,29,38.6
36081039400,2814,2814,2651,163,23,38
36081039800,1657,1657,1549,108,33,35.9
36081039900,4132,4132,840,3292,1130,42.3
36081040000,1267,1267,1197,70,10,37.4
36081040100,7527,7527,1201,6326,1938,40.1
36081040200,1368,1368,1284,84,13,40.3
36081040300,6777,6777,1030,5747,1885,31
36081040400,3918,3918,3511,407,164,38.7
36081040500,3303,3303,246,3057,884,37.5
36081040700,8304,8304,903,7401,2578,43.2
36081040900,5094,5094,678,4416,1772,40.9
36081041100,3947,3947,645,3302,1402,37.9
36081041300,4464,4464,941,3523,1721,30.4
36081041400,4033,4033,3407,626,214,32.4
36081041500,4278,4278,900,3378,1987,35.6
36081042400,2161,2161,2047,114,29,43.2
36081042600,512,512,480,32,218,67.3
36081042700,4604,4604,944,3660,1963,32.5
36081043200,1166,1166,1102,64,25,37.8
36081043400,1956,1956,1788,168,57,42.8
36081043701,3381,3381,1370,2011,1663,51.7
36081043702,6476,6476,2422,4054,2042,42.6
36081043900,4790,4790,730,4060,1815,33.9
36081044000,3669,3669,3161,508,136,32.1
36081044301,4033,4033,1106,2927,1469,43.4
36081044302,5223,5223,2997,2226,1169,39.1
36081044400,3236,3236,2089,1147,476,37.5
36081044601,3367,3367,1905,1462,655,46
36081044602,4596,4596,2994,1602,599,38.3
36081044800,2571,2571,2053,518,454,38.5
36081045000,1943,1943,1527,416,630,32.9
36081045200,1153,1153,1022,131,386,79.2
36081045400,4773,4773,4255,518,449,41.4
36081045500,12330,12330,8289,4041,3582,39.3
36081045600,1338,1338,1174,164,232,36.5
36081045700,3355,3355,2306,1049,742,40
36081045800,2016,2016,1737,279,329,44
36081045900,3975,3975,2476,1499,862,29.3
36081046000,6006,6006,3793,2213,875,44.9
36081046100,3089,3089,1542,1547,820,42.5
36081046200,7296,7296,4866,2430,1137,38.9
36081046300,4284,4284,1532,2752,1125,39.7
36081046400,1643,1643,1379,264,545,28.3
36081046500,4247,4247,749,3498,1443,36.5
36081046600,3058,3058,2535,523,741,40.3
36081046700,7112,7112,2723,4389,2360,39.8
36081046800,3829,3829,2890,939,468,33.6
36081046900,8570,8570,3644,4926,2748,46.3
36081047000,3247,3247,2363,884,436,37.8
36081047100,4425,4425,3117,1308,973,42.8
36081047200,3760,3760,3147,613,1016,45
36081047300,3997,3997,3053,944,1042,36.8
36081047500,4835,4835,3617,1218,1189,39.2
36081047600,1326,1326,1198,128,645,43.5
36081047800,5294,5294,4319,975,1272,44.4
36081047900,5456,5456,4324,1132,1208,36.4
36081048000,2506,2506,1999,507,324,39.8
36081048100,6781,6781,4202,2579,1624,52.7
36081048200,1452,1452,1167,285,198,44.4
36081048300,4047,4047,2824,1223,946,38.3
36081048400,4979,4979,4099,880,453,37.2
36081048500,4598,4598,3850,748,744,44.5
36081048900,1486,1486,1004,482,489,33.5
36081049200,4750,4750,4025,725,536,40.2
36081049301,2134,2134,1686,448,1229,40
36081049302,2811,2811,1957,854,1999,49.8
36081049500,1358,1358,1017,341,1052,10.5
36081049600,3030,3030,2452,578,336,37.4
36081049700,3021,3021,2375,646,1635,44.5
36081049900,5071,5071,4094,977,1570,30.2
36081050000,4323,4323,3679,644,267,36.8
36081050201,1410,1410,1219,191,54,34.5
36081050202,1344,1344,1218,126,42,36
36081050400,1831,1831,1683,148,47,36.9
36081050500,1657,1657,1348,309,876,27.8
36081050600,1553,1553,1434,119,30,38.6
36081050700,3442,3442,2957,485,2372,28.9
36081050800,1837,1837,1720,117,45,37.6
36081051000,1540,1540,1377,163,35,39.7
36081051100,2097,2097,1648,449,1633,33
36081051200,2619,2619,2300,319,80,38.1
36081051300,2367,2367,1856,511,1535,34.3
36081051500,2852,2852,2287,565,2316,44
36081051600,1866,1866,1707,159,53,39.5
36081051700,1957,1957,1526,431,1658,29.7
36081051800,1931,1931,1844,87,12,37.5
36081052000,1521,1521,1419,102,33,38.6
36081052100,1983,1983,1415,568,1567,26.7
36081052200,1532,1532,1451,81,8,38.2
36081052400,1739,1739,1640,99,10,37.2
36081052500,2063,2063,1415,648,1500,36.8
36081052600,1802,1802,1668,134,25,35.3
36081052800,1442,1442,1375,67,15,36
36081053000,2240,2240,2152,88,26,39.1
36081053100,3114,3114,2122,992,2486,27.5
36081053200,1675,1675,1597,78,31,39.9
36081053401,1907,1907,1792,115,64,39.5
36081053500,1123,1123,371,752,630,32.3
36081053601,1577,1577,1440,137,33,38.6
36081053800,1755,1755,1549,206,68,37
36081053900,4147,4147,1900,2247,1774,29.4
36081054000,4222,4222,3472,750,301,37.4
36081054200,5074,5074,3975,1099,806,40.3
36081054500,3722,3722,1147,2575,1690,27.1
36081054700,4643,4643,1414,3229,1830,31
36081054800,2319,2319,1939,380,288,42.1
36081054900,5308,5308,1801,3507,2561,30.8
36081055100,4573,4573,2473,2100,2830,30.5
36081055200,3064,3064,2251,813,605,43.2
36081055300,2454,2454,785,1669,772,31.7
36081055400,2303,2303,1737,566,709,38.4
36081055500,2147,2147,602,1545,841,31.8
36081055600,2153,2153,1597,556,498,40.8
36081055700,3915,3915,1627,2288,1931,31.8
36081055800,1732,1732,1296,436,471,32.9
36081055900,1217,1217,328,889,482,33.1
36081056000,1647,1647,1152,495,517,31
36081056100,73,73,47,26,44,32
36081056200,1517,1517,1060,457,554,36.5
36081056400,1783,1783,1189,594,550,31.9
36081056500,1567,1567,363,1204,661,35.5
36081056600,1487,1487,1141,346,307,37.1
36081056700,4574,4574,2170,2404,2946,32.5
36081056800,4550,4550,3610,940,616,37.4
36081057700,3625,3625,2281,1344,2684,32.3
36081057900,1592,1592,1020,572,1215,30.5
36081058000,3641,3641,3302,339,189,39.8
36081058100,2662,2662,1710,952,2012,33.9
36081058200,4490,4490,4067,423,272,38.5
36081058300,3254,3254,2092,1162,2349,34.7
36081058500,4062,4062,2546,1516,2932,29.3
36081058700,3296,3296,2531,765,2552,32.1
36081058900,4196,4196,2508,1688,3143,29.2
36081059000,1074,1074,1021,53,12,40.6
36081059100,5826,5826,2533,3293,3589,26.7
36081059200,1280,1280,1231,49,36,45.2
36081059300,3881,3881,2865,1016,3054,37.3
36081059400,1537,1537,1453,84,36,42.1
36081059500,4700,4700,2657,2043,3097,28.7
36081059600,1304,1304,1263,41,25,43
36081059800,1643,1643,1537,106,32,39.1
36081059900,1525,1525,1216,309,1269,20
36081060000,1056,1056,1009,47,32,44.4
36081060100,2111,2111,1510,601,1637,34.5
36081060300,1706,1706,1199,507,1359,33.5
36081060600,1381,1381,1293,88,23,41
36081060701,25,25,19,6,20,0
36081060800,1413,1413,1353,60,17,42.3
36081061000,1268,1268,1216,52,26,43.5
36081061200,1597,1597,1514,83,33,43.6
36081061301,5295,5295,3816,1479,4123,26
36081061302,19,19,15,4,15,0
36081061400,1234,1234,1164,70,17,42.6
36081061601,2180,2180,2070,110,47,43
36081061602,1152,1152,1102,50,54,40
36081061800,1583,1583,1505,78,54,43.5
36081061900,2783,2783,2137,646,2364,32.3
36081062000,1440,1440,1352,88,29,43.6
36081062100,2746,2746,2001,745,2287,35.5
36081062200,1983,1983,1867,116,55,43.1
36081062300,1789,1789,1332,457,1518,29.3
36081062400,1,1,1,0,0,60.5
36081062500,2388,2388,1727,661,1968,26.3
36081062600,2620,2620,2455,165,53,39.9
36081062700,2879,2879,1985,894,2253,26.1
36081062900,2782,2782,1941,841,2191,30.3
36081063000,1579,1579,1508,71,26,42.3
36081063200,2134,2134,2002,132,48,41.5
36081063301,1416,1416,1098,318,1249,30.5
36081063302,1476,1476,1198,278,1292,26.8
36081063500,2513,2513,1990,523,2186,32
36081063700,3148,3148,2482,666,2680,30
36081063800,3425,3425,3078,347,345,37.1
36081063900,2747,2747,2054,693,2204,37.5
36081064101,1960,1960,1569,391,1546,38
36081064102,113,113,94,19,103,0
36081064500,1979,1979,1630,349,1213,39
36081064600,2829,2829,2705,124,59,42.2
36081065000,2650,2650,2534,116,64,41.7
36081065400,2788,2788,2491,297,241,33.9
36081065501,0,0,0,0,0,0
36081065600,4853,4853,4383,470,365,32.5
36081065702,1675,1675,1365,310,1425,23.5
36081065703,2597,2597,2271,326,2416,29.5
36081065900,1666,1666,1561,105,1578,56.5
36081066000,3233,3233,2875,358,281,34.3
36081066100,1495,1495,1380,115,1408,36
36081066300,2601,2601,2323,278,2208,20.5
36081066400,9612,9612,8792,820,724,33.4
36081066501,3275,3275,2992,283,3127,37.5
36081066701,2575,2575,2253,322,2279,30
36081066900,1706,1706,1570,136,1528,37.5
36081067100,2100,2100,1951,149,1741,31
36081067700,1786,1786,1630,156,1610,35.5
36081067900,4094,4094,2968,1126,2918,62.8
36081068000,4708,4708,4409,299,152,37
36081068200,1102,1102,1038,64,24,38.9
36081068300,4210,4210,2484,1726,1383,39.8
36081068700,4630,4630,3760,870,2099,38
36081069000,3252,3252,2997,255,101,35
36081069300,2883,2883,2306,577,1586,39.5
36081069400,3314,3314,3080,234,125,33.2
36081069500,2128,2128,1742,386,1171,40.5
36081069701,3616,3616,2992,624,2243,36.5
36081069702,3911,3911,3472,439,2161,37.5
36081070300,2010,2010,1547,463,1308,39.5
36081070700,2303,2303,2043,260,1374,49
36081070900,2483,2483,2221,262,1393,37.5
36081071100,5272,5272,4611,661,3331,39.8
36081071303,4973,4973,4292,681,3633,36.8
36081071304,6136,6136,5549,587,4752,45.8
36081071305,4871,4871,4357,514,3103,38.3
36081071306,5811,5811,4862,949,3682,34.7
36081071600,0,0,0,0,0,0
36081071701,5161,5161,4442,719,3385,41.3
36081071702,3921,3921,3317,604,1933,51.8
36081071900,2630,2630,2271,359,1778,50.2
36081072100,4963,4963,4300,663,3439,45
36081072300,2127,2127,1986,141,1407,38
36081072900,1363,1363,1180,183,812,26.8
36081073100,1515,1515,1380,135,974,38.3
36081073700,2042,2042,1799,243,1446,34.5
36081073900,5028,5028,4453,575,3692,45.8
36081074100,3015,3015,2696,319,2127,39.5
36081074300,4221,4221,3623,598,2780,36.6
36081074500,3571,3571,2954,617,2398,44.9
36081074700,3386,3386,2804,582,1390,44.3
36081074900,1453,1453,1349,104,1109,43.5
36081075701,4678,4678,4109,569,2857,40.8
36081075702,4481,4481,4153,328,3048,54.6
36081076901,4056,4056,3519,537,2848,41.3
36081076902,1371,1371,1177,194,840,35.5
36081077300,2234,2234,1834,400,1491,40.5
36081077500,2273,2273,1857,416,1592,36.8
36081077902,5263,5263,4971,292,4550,36
36081077903,2972,2972,2187,785,1842,41.5
36081077904,6155,6155,5261,894,3978,39.6
36081077905,2455,2455,2021,434,1197,44.8
36081077906,3633,3633,3161,472,2277,42.8
36081077907,3193,3193,2799,394,2510,34.5
36081077908,3755,3755,3077,678,1654,33.6
36081078800,1818,1818,1640,178,73,37.2
36081079000,2549,2549,2225,324,116,33.8
36081079200,2280,2280,1974,306,94,39.7
36081079300,1,1,0,1,0,0
36081079701,7055,7055,6663,392,814,54.2
36081079702,4502,4502,3834,668,601,50.8
36081079900,3425,3425,2845,580,742,38
36081080301,4382,4382,3703,679,948,31.5
36081080302,3504,3504,2960,544,1297,37
36081080900,6850,6850,5841,1009,4387,39.4
36081081400,3543,3543,2897,646,215,36.4
36081081800,3478,3478,2783,695,403,36.3
36081083700,5388,5388,4982,406,944,37
36081083800,4970,4970,3555,1415,1447,34.2
36081084000,6478,6478,4860,1618,1221,35.1
36081084500,5318,5318,4362,956,993,48.6
36081084601,2730,2730,2027,703,820,35.5
36081084602,1053,1053,734,319,271,25.5
36081084900,7642,7642,6288,1354,865,49.4
36081085300,5764,5764,5286,478,467,53.2
36081085500,6649,6649,5201,1448,1319,43.5
36081085700,5953,5953,4876,1077,970,55.8
36081085900,5873,5873,5097,776,971,44.3
36081086100,2370,2370,2021,349,478,43.5
36081086300,7277,7277,5980,1297,1094,51.4
36081086400,2634,2634,1555,1079,971,30.9
36081086500,4514,4514,4079,435,934,54.3
36081086900,2131,2131,1876,255,178,46.5
36081087100,1752,1752,1136,616,346,30.2
36081088400,7337,7337,6455,882,6761,29.5
36081088901,10266,10266,8587,1679,3168,40.1
36081089200,7430,7430,6930,500,7075,43
36081090700,1355,1355,911,444,768,24.8
36081091601,4079,4079,3991,88,4004,28.5
36081091602,0,0,0,0,0,0
36081091800,17,17,13,4,16,0
36081091900,5766,5766,3881,1885,2572,50.6
36081092200,2206,2206,2141,65,2121,44.5
36081092500,3681,3681,2013,1668,1782,32.5
36081092800,3246,3246,3106,140,3124,43.5
36081092900,6496,6496,4258,2238,3248,30.8
36081093401,3789,3789,3568,221,3608,56.3
36081093402,3657,3657,3257,400,3186,46.1
36081093800,5218,5218,4356,862,3949,48.5
36081093900,4400,4400,3023,1377,2237,35.5
36081094201,3380,3380,2300,1080,1220,31.3
36081094202,4700,4700,3377,1323,1415,27.9
36081094203,5369,5369,4508,861,3401,42.4
36081094500,3971,3971,3219,752,2659,40.5
36081094700,2577,2577,1523,1054,1492,29
36081095400,5368,5368,4227,1141,975,30.7
36081096400,4441,4441,3629,812,560,32
36081097202,2795,2795,2261,534,140,24.5
36081097203,6865,6865,4667,2198,784,25.9
36081097204,3544,3544,2777,767,533,37.3
36081097300,2016,2016,1840,176,1769,24.5
36081098100,2249,2249,2000,249,1623,24.5
36081098700,2444,2444,2121,323,1994,44.5
36081099100,6507,6507,5940,567,5562,50.5
36081099200,3803,3803,2727,1076,748,29.1
36081099701,2670,2670,2458,212,2091,37.5
36081099703,3892,3892,3553,339,2755,41.3
36081099704,6868,6868,6353,515,5340,47.5
36081099705,2632,2632,2388,244,1537,41.3
36081099801,7608,7608,5364,2244,1075,35.4
36081099802,5283,5283,4279,1004,1578,33.3
36081099900,0,0,0,0,0,0
36081100801,2327,2327,2113,214,993,34.8
36081100802,8106,8106,6142,1964,1988,31
36081101001,9943,9943,7061,2882,3663,37.2
36081101002,4138,4138,3884,254,3347,58.1
36081101700,5689,5689,5144,545,4402,37.5
36081102900,3319,3319,2952,367,2426,54.5
36081103201,6456,6456,4323,2133,706,27
36081103202,6197,6197,4526,1671,3638,35.5
36081103300,4116,4116,3656,460,3234,22
36081103900,6151,6151,5293,858,4117,46.5
36081104700,7314,7314,6535,779,3698,38.5
36081105900,3556,3556,3278,278,2463,38
36081107201,2443,2443,2279,164,2316,54.5
36081107202,0,0,0,0,0,0
36081108500,2613,2613,2320,293,1608,37.5
36081109300,3034,3034,2785,249,2032,50
36081109700,1887,1887,1649,238,1339,19.5
36081109900,3277,3277,2797,480,2112,41.5
36081111300,2559,2559,2313,246,1607,50.3
36081112300,2102,2102,1729,373,1017,45.1
36081112900,2242,2242,2033,209,1531,31
36081113300,1537,1537,1350,187,1127,29.5
36081113900,3322,3322,2805,517,1982,38.5
36081114100,2406,2406,2159,247,1694,38
36081114700,1673,1673,1477,196,1118,50.5
36081115100,1116,1116,1028,88,692,38
36081115500,2114,2114,1487,627,918,34.3
36081115700,3388,3388,2940,448,892,41.5
36081115900,3991,3991,3400,591,988,46.3
36081116100,4589,4589,4000,589,827,54.4
36081116300,9104,9104,7194,1910,1664,50.8
36081116700,2067,2067,1514,553,380,40.5
36081117100,2743,2743,2174,569,799,34.5
36081117500,4990,4990,4301,689,2109,33
36081118100,1840,1840,1659,181,976,33
36081118500,2114,2114,1530,584,615,38.6
36081118700,2521,2521,1952,569,578,39
36081118900,2468,2468,2100,368,450,34.5
36081119100,3273,3273,2468,805,982,47.8
36081119300,2252,2252,1836,416,851,45.5
36081119500,1349,1349,1078,271,730,30.5
36081119900,1507,1507,1295,212,500,39.5
36081120100,1668,1668,1343,325,347,42
36081120300,1642,1642,1449,193,353,35
36081120500,3024,3024,2684,340,425,52.5
36081120700,2794,2794,2250,544,1290,38.8
36081121100,0,0,0,0,0,0
36081121500,4101,4101,3378,723,1056,33.5
36081122300,3533,3533,3145,388,1544,30.1
36081122701,10910,10910,8637,2273,5277,33.6
36081122702,6427,6427,4676,1751,2088,29.2
36081124100,3897,3897,3410,487,1741,35.9
36081124700,3550,3550,3348,202,2013,31
36081125700,3203,3203,2613,590,857,51.8
36081126500,1660,1660,1385,275,563,45.4
36081126700,4057,4057,3451,606,1687,19.4
36081127700,3633,3633,3469,164,2845,38.5
36081128300,73,73,69,4,59,38.5
36081129102,3341,3341,3041,300,2394,39.5
36081129103,3566,3566,3211,355,2615,46.1
36081129104,4102,4102,3691,411,2542,47.5
36081130100,3791,3791,3140,651,1594,42.7
36081133300,3679,3679,3387,292,1898,44
36081133900,1302,1302,1198,104,749,48.5
36081134100,3259,3259,2989,270,1258,30.5
36081134700,9572,9572,8475,1097,2870,42
36081136700,5879,5879,5510,369,2501,37
36081137700,6606,6606,6004,602,2136,35.6
36081138501,4743,4743,4387,356,1568,35.8
36081138502,72,72,64,8,60,20.5
36081139900,1744,1744,1619,125,807,42.5
36081140300,2302,2302,2095,207,945,26.5
36081140901,914,914,854,60,427,36.5
36081140902,2603,2603,2376,227,986,26
36081141700,4475,4475,3973,502,1986,36.3
36081142900,3624,3624,3265,359,2070,40
36081143500,2199,2199,2003,196,1028,38
36081144100,2926,2926,2642,284,1547,33.3
36081144700,2927,2927,2529,398,645,46.2
36081145101,1360,1360,1247,113,768,36
36081145102,2468,2468,2079,389,871,44
36081145900,2772,2772,2328,444,1588,29
36081146300,3000,3000,2582,418,1602,39.5
36081146700,2736,2736,2362,374,1647,32.3
36081147100,3341,3341,3001,340,1740,48.5
36081147900,4241,4241,3749,492,2476,39.5
36081148300,2863,2863,2706,157,1990,37.5
36081150701,2930,2930,2702,228,2027,40.8
36081150702,3178,3178,2883,295,2036,70.5
36081152901,6401,6401,5870,531,2820,41.3
36081152902,5126,5126,4814,312,3146,37.2
36081155101,1806,1806,1782,24,1745,61
36081155102,8185,8185,7202,983,5021,46.8
36081156700,1790,1790,1588,202,417,39.8
36081157101,7216,7216,6422,794,2794,39.4
36081157102,1996,1996,1746,250,634,36
36081157901,4800,4800,4481,319,2249,40
36081157902,3836,3836,3483,353,1420,36.5
36081157903,3944,3944,3541,403,1903,35.2
36081161700,4297,4297,3481,816,2578,34.2
36081162100,6197,6197,4832,1365,2190,30.9
36081990100,0,0,0,0,0,0
36085000300,1927,1927,1483,444,1073,39
36085000600,2408,2408,1933,475,1802,43
36085000700,4915,4915,3618,1297,1522,30.4
36085000800,5583,5583,4141,1442,3667,30.3
36085000900,2112,2112,1451,661,746,30.9
36085001100,3987,3987,2409,1578,1496,28.8
36085001700,1788,1788,1050,738,936,29.5
36085001800,731,731,574,157,568,28.8
36085002001,2504,2504,2106,398,1984,36.5
36085002002,3258,3258,2859,399,2562,36.3
36085002100,4236,4236,2676,1560,1610,29.1
36085002700,2217,2217,1249,968,937,35.8
36085002900,5207,5207,3138,2069,1105,26.6
36085003300,3402,3402,2649,753,1855,34.1
36085003600,2510,2510,1892,618,1598,29
36085003900,2197,2197,1701,496,1303,34.5
36085004000,12998,12998,9506,3492,2668,28.2
36085004700,3863,3863,3346,517,3009,23.1
36085005000,3847,3847,3277,570,2901,31.5
36085005900,2635,2635,2358,277,2239,36.6
36085006400,3550,3550,2807,743,2457,24.4
36085006700,2758,2758,2505,253,2269,32.5
36085007000,8525,8525,7239,1286,6998,36.2
36085007400,4693,4693,3782,911,3481,30.9
36085007500,3914,3914,2650,1264,1994,31.1
36085007700,1535,1535,928,607,322,27.9
36085008100,4301,4301,3142,1159,1908,40.9
36085008900,0,0,0,0,0,0
36085009601,4024,4024,3624,400,3408,48.5
36085009602,3461,3461,3032,429,2937,37.5
36085009700,3925,3925,2855,1070,1944,27.3
36085010500,5153,5153,3586,1567,2688,30.8
36085011201,5758,5758,5154,604,4948,32.3
36085011202,6428,6428,5303,1125,5382,35.9
36085011401,3067,3067,2405,662,2078,28.5
36085011402,3450,3450,2956,494,2931,33.3
36085012100,3065,3065,2840,225,2814,52
36085012200,3813,3813,3441,372,3486,29.5
36085012500,2939,2939,1984,955,1522,30.8
36085012804,4259,4259,3724,535,3631,33.5
36085012805,3158,3158,2879,279,2894,41
36085012806,5955,5955,5113,842,5008,34
36085013201,1558,1558,1474,84,1451,35.5
36085013203,5433,5433,5011,422,5085,31
36085013204,4843,4843,4348,495,4428,29.5
36085013301,1633,1633,1023,610,303,22.9
36085013302,3587,3587,1774,1813,1064,28.6
36085013400,3946,3946,3397,549,3505,30
36085013800,6535,6535,6026,509,6159,18.5
36085014100,2690,2690,1581,1109,1464,30.6
36085014604,6422,6422,5986,436,5990,36.5
36085014605,3836,3836,3526,310,3597,30.5
36085014606,6372,6372,5782,590,5953,34.5
36085014607,4552,4552,4153,399,4179,37
36085014608,3510,3510,3206,304,3185,32.5
36085014700,3412,3412,3104,308,3056,41.5
36085015100,5141,5141,4577,564,4476,26.8
36085015400,0,0,0,0,0,0
36085015601,6330,6330,5884,446,6035,31.8
36085015602,3320,3320,3174,146,3147,35.5
36085015603,4265,4265,3924,341,3985,40.5
36085016901,2970,2970,2572,398,2318,32.5
36085017005,4507,4507,4219,288,4145,42.5
36085017007,4968,4968,4174,794,3756,33.4
36085017008,7388,7388,6856,532,6856,33
36085017009,4299,4299,4094,205,4084,39.5
36085017010,8583,8583,7554,1029,7576,39.8
36085017011,4549,4549,4178,371,4176,35.3
36085017012,4279,4279,3948,331,3932,36
36085017300,2523,2523,2038,485,1254,29.8
36085017600,4815,4815,4583,232,4488,40.3
36085017700,7001,7001,6576,425,5788,33
36085018100,2974,2974,2708,266,2616,58
36085018701,1807,1807,1550,257,1358,38.2
36085018702,7485,7485,6526,959,4740,45.9
36085018901,5333,5333,4728,605,4434,33.9
36085018902,5064,5064,4500,564,3290,38.8
36085019700,1867,1867,1736,131,1672,37.5
36085019800,6300,6300,5868,432,5851,30
36085020100,3572,3572,2624,948,2635,34.6
36085020700,6399,6399,2979,3420,2001,31.3
36085020801,8977,8977,8328,649,8265,32.8
36085020803,6463,6463,5976,487,6071,33.5
36085020804,5323,5323,4997,326,5009,26
36085021300,5376,5376,2931,2445,2638,29.9
36085022300,2880,2880,1633,1247,1020,28.2
36085022600,8490,8490,7638,852,7208,41.3
36085022800,105,105,61,44,70,0
36085023100,4683,4683,2722,1961,1646,29.1
36085023900,3250,3250,1826,1424,1450,33.5
36085024401,5823,5823,5457,366,5499,29.3
36085024402,4259,4259,3996,263,4031,41.8
36085024700,2702,2702,1832,870,1349,32.2
36085024800,4741,4741,4170,571,4324,38
36085025100,5714,5714,5062,652,4961,42.5
36085027301,3820,3820,3428,392,2932,41
36085027302,3667,3667,3417,250,2676,32.4
36085027702,6193,6193,5403,790,4681,34.4
36085027704,4108,4108,3688,420,3187,24.8
36085027705,5351,5351,4675,676,4111,30.3
36085027706,2950,2950,2545,405,2192,35
36085027900,2137,2137,1999,138,2033,31
36085029102,2953,2953,2455,498,2412,33.5
36085029103,7245,7245,6296,949,6189,36.1
36085029104,6735,6735,5567,1168,5066,36.2
36085030301,4929,4929,3714,1215,2943,33
36085030302,6369,6369,4206,2163,2926,33.4
36085031901,3265,3265,2173,1092,593,26.8
36085031902,4848,4848,3350,1498,997,26.7
36085032300,1250,1250,808,442,485,33.9
36085990100,0,0,0,0,0,0
